test_id,question1,question2,ques1_len,ques2_len,len_diff,q1_word_len,q2_word_len,words_diff,q1_caps_count,q2_caps_count,caps_diff,q1_char_len,q2_char_len,diff_char_len,avg_word_len1,avg_word_len2,diff_avg_word,common_word,total_word,word_share,share_2_gram
0,How does the Surface Pro himself 4 compare with iPad Pro?,Why did Microsoft choose core m3 and not core i3 home Surface Pro 4?,57,68,-11,11,14,-3,5,4,1,47,55,-8,4.2727272727272725,3.9285714285714284,0.3441558441558441,2.0,24.0,0.08333333333333333,0.043478260869565216
1,Should I have a hair transplant at age 24? How much would it cost?,How much cost does hair transplant require?,66,43,23,14,7,7,3,1,2,53,37,16,3.7857142857142856,5.285714285714286,-1.5,4.0,21.0,0.19047619047619047,0.10526315789473684
2,What but is the best way to send money from China to the US?,What you send money to China?,60,29,31,14,6,8,4,2,2,47,24,23,3.357142857142857,4.0,-0.6428571428571428,4.0,18.0,0.2222222222222222,0.05555555555555555
3,Which food not emulsifiers?,What foods fibre?,27,17,10,4,3,1,1,1,0,24,15,9,6.0,5.0,1.0,0.0,7.0,0.0,0.0
4,"How ""aberystwyth"" start reading?",How their can I start reading?,32,30,2,4,6,-2,1,2,-1,29,25,4,7.25,4.166666666666667,3.083333333333333,3.0,10.0,0.3,0.125
5,How are the two wheeler insurance from Bharti Axa insurance?,I admire I am considering of buying insurance from them,60,55,5,10,10,0,3,2,1,51,46,5,5.1,4.6,0.5,2.0,19.0,0.10526315789473684,0.05555555555555555
6,How can I reduce my belly fat through a diet?,How can I reduce my lower belly fat in one month?,45,49,-4,10,11,-1,2,2,0,36,39,-3,3.6,3.5454545454545454,0.054545454545454675,7.0,21.0,0.3333333333333333,0.2631578947368421
7,"By scrapping the 500 and 1000 rupee notes, how is RBI planning to fight against issue black money?",How will the recent move to declare 500 and 1000 denomination lewin illegal will curb black money?,98,98,0,18,17,1,4,1,3,81,82,-1,4.5,4.823529411764706,-0.3235294117647056,8.0,34.0,0.23529411764705882,0.09090909090909091
8,What are the how best books of all time?,What are some of the military history books of all time?,40,56,-16,9,11,-2,1,1,0,32,46,-14,3.5555555555555554,4.181818181818182,-0.6262626262626263,7.0,19.0,0.3684210526315789,0.2222222222222222
9,"After 12th years old boy and I had sex with a 12 years old girl, with her consent. Is there anything wrong?",Can a 14 old guy date a 12 year old girl?,107,41,66,22,11,11,3,1,2,86,31,55,3.909090909090909,2.8181818181818183,1.0909090909090908,3.0,28.0,0.10714285714285714,0.03333333333333333
10,What is the best slideshow app for Android?,What are the best app for android?,43,34,9,8,7,1,2,1,1,36,28,8,4.5,4.0,0.5,6.0,15.0,0.4,0.23076923076923078
11,"What services are from Google: Facebook, YouTube betray Twitter?","What social network (like Google, Facebook, WhatsApp, Viber, Twitter, YouTube, Instagram, Skype, Wiki, etc.) made huge impact on people and lifestyles?",64,151,-87,9,21,-12,6,12,-6,56,131,-75,6.222222222222222,6.238095238095238,-0.015873015873015817,2.0,30.0,0.06666666666666667,0.0
12,What if a cricket hits a batsmanâ€™s helmet and then goes to the boundary?,Should carbonated red balls and 8 yellow balls. If 5 balls are drawn what is the probability of getting 2 red balls and 3 yellow balls?,74,135,-61,14,26,-12,1,2,-1,61,110,-49,4.357142857142857,4.230769230769231,0.12637362637362592,4.0,34.0,0.11764705882352941,0.0
13,Just how do you learn fruity loops?,How do Fruity Wrappers work?,35,28,7,7,5,2,1,3,-2,29,24,5,4.142857142857143,4.8,-0.6571428571428566,3.0,12.0,0.25,0.1
14,Why does Batman get kill in Batman v Superman?,"In Batman v Superman, why reduce Lex Luthor pit Superman against Batman?",46,72,-26,9,12,-3,4,7,-3,38,61,-23,4.222222222222222,5.083333333333333,-0.8611111111111107,4.0,20.0,0.2,0.10526315789473684
15,When can I buy a SpaceX stock?,Should I sell or buy LNKD stock?,30,32,-2,7,7,0,4,6,-2,24,26,-2,3.4285714285714284,3.7142857142857144,-0.28571428571428603,3.0,14.0,0.21428571428571427,0.0
16,Is it gouging and price fixing?,"What's the difference between intel of something"" and ""price for something""?",31,76,-45,6,11,-5,1,1,0,26,66,-40,4.333333333333333,6.0,-1.666666666666667,1.0,17.0,0.058823529411764705,0.0
17,Can a vacuum cleaner concentrate suck your eye out if it is pressed against your face?,Could a vacuum cleaner suck get your eye out if directly pressed on the face?,86,77,9,16,15,1,1,1,0,71,63,8,4.4375,4.2,0.23749999999999982,10.0,30.0,0.3333333333333333,0.1724137931034483
18,I am 20 years old and I still a problem with pimples. What is the remedy?,I am 20 years old and still have acne. It seems more like inner mcent What is some known cure?,73,94,-21,16,20,-4,3,3,0,58,75,-17,3.625,3.75,-0.125,9.0,35.0,0.2571428571428571,0.17647058823529413
19,What is it ai living in the middle class?,Why middle class?,41,17,24,9,3,6,1,1,0,33,15,18,3.6666666666666665,5.0,-1.3333333333333335,2.0,12.0,0.16666666666666666,0.1
20,How matter at MIT? Will performing poorly in 11 grade affect my chance?,"I have passed 5 AP tests with scores trump 5. Can I apply to UC Berkeley at 11 grade? If I got rejected, does it hurt my chance next year?",71,138,-67,13,30,-17,5,10,-5,59,109,-50,4.538461538461538,3.6333333333333333,0.905128205128205,3.0,41.0,0.07317073170731707,0.0
21,What possible with XAT percentile between 85 and 90?,Is it possible that a person getting below 90 percentile in weren CAT cracked IIFT/XAT/NMAT/SNAP?,52,97,-45,9,15,-6,4,19,-15,44,83,-39,4.888888888888889,5.533333333333333,-0.6444444444444439,2.0,24.0,0.08333333333333333,0.0
22,What are the differences between clients and servers?,What is the difference between a server and a database?,53,55,-2,8,10,-2,1,1,0,46,46,0,5.75,4.6,1.1500000000000004,4.0,17.0,0.23529411764705882,0.0
23,I want to eat hacking where should I start?,If I want to learn processor what should I do?,43,46,-3,9,10,-1,2,3,-1,35,37,-2,3.888888888888889,3.7,0.18888888888888866,4.0,17.0,0.23529411764705882,0.17647058823529413
24,Why do people like Hrithik Roshan tax much?,Who will win the clash on 26th January welfare Raees or Hrithik Roshan's Kaabil and why?,43,88,-45,8,16,-8,3,6,-3,36,73,-37,4.5,4.5625,-0.0625,1.0,24.0,0.041666666666666664,0.0
25,What should be the first computer table language I learn?,Which language should I x^4 as a first programming language?,57,60,-3,10,10,0,2,2,0,48,51,-3,4.8,5.1,-0.2999999999999998,4.0,20.0,0.2,0.0
26,What is a selling good dose to get high on klonopin on an empty stomach with a low benzo tolerance and not fall asleep?,Is 3mg always of Xanax a high dose?,119,35,84,24,8,16,1,2,-1,96,28,68,4.0,3.5,0.5,3.0,30.0,0.1,0.0
27,What shall I rights to study BA economics at LSE?,What subjects should I be good at if I want gmat study economics at college and do very well?,49,93,-44,10,19,-9,7,3,4,40,75,-35,4.0,3.9473684210526314,0.052631578947368585,5.0,27.0,0.18518518518518517,0.037037037037037035
28,What is the pH of zinc powder reacted with dilute hydrochloric acid?,Does copper oxide react with hydrochloric acid?,68,47,21,12,7,5,2,1,1,57,41,16,4.75,5.857142857142857,-1.1071428571428568,3.0,19.0,0.15789473684210525,0.058823529411764705
29,"Are there Doctor Who references in the Muse song ""Knights of Cydonia""?","In ""The Big Bang"" episode of Doctor Who, how does River Song remember to give her diary to Amy when the Doctor has been wiped out of everyone's memory?",70,151,-81,12,29,-17,6,10,-4,59,123,-64,4.916666666666667,4.241379310344827,0.6752873563218396,5.0,38.0,0.13157894736842105,0.0
30,What's the best thing your break-up has done (13 you?,What is the is the best thing to do after break up?,53,51,2,10,12,-2,1,1,0,44,40,4,4.4,3.3333333333333335,1.0666666666666669,3.0,20.0,0.15,0.10526315789473684
31,Can information practices be used in a sentence?,How can ranji word 'aquamarine' be used in a sentence?,48,54,-6,8,10,-2,1,1,0,41,45,-4,5.125,4.5,0.625,6.0,18.0,0.3333333333333333,0.25
32,What is it like to leave the Army with improve dishonorable discharge?,How many people are dishonorably discharged from the scopes US armed forces every year?,70,87,-17,12,14,-2,2,3,-1,59,74,-15,4.916666666666667,5.285714285714286,-0.3690476190476186,1.0,26.0,0.038461538461538464,0.0
33,"How do I can I promote a ""launching soon"" Startup page?","What is the free, simplest & fastest way to promote a know page for a new startup?",55,82,-27,11,17,-6,4,1,3,45,66,-21,4.090909090909091,3.8823529411764706,0.20855614973262027,2.0,26.0,0.07692307692307693,0.038461538461538464
34,Why is a bunny the change character in Zootopia?,What was the motivation to make a rabbit as the main character of the trust movie?,48,82,-34,9,16,-7,2,1,1,40,67,-27,4.444444444444445,4.1875,0.25694444444444464,3.0,23.0,0.13043478260869565,0.0
35,What site the best example of dedication in any field?,What are some of the best examples of new in any field?,54,55,-1,10,12,-2,1,1,0,45,44,1,4.5,3.6666666666666665,0.8333333333333335,7.0,21.0,0.3333333333333333,0.15
36,"My IB Physics IA's question is ""What is the relationship between the radius of the ball, the angle, and the distance traveled?"". lie it work?",I am starting my IB Math SL IA and I am thinking of modeling infectious diseases as my topic. Would that work? I'm not sure exactly how to approach like?,141,153,-12,25,30,-5,7,11,-4,117,124,-7,4.68,4.133333333333334,0.546666666666666,5.0,47.0,0.10638297872340426,0.019230769230769232
37,Is it christians to create synthetic gold?,Is give it possible to turn lead into gold?,42,43,-1,7,9,-2,1,1,0,36,35,1,5.142857142857143,3.888888888888889,1.2539682539682544,4.0,16.0,0.25,0.0
38,What way is the most possible one to time travel?,Is it possible to time travel in the distant future?,49,52,-3,10,10,0,1,1,0,40,43,-3,4.0,4.3,-0.2999999999999998,5.0,20.0,0.25,0.05555555555555555
39,How do I get a job for a earth profile in Canada?,How do I get a wouldn job at .net?,49,34,15,12,9,3,3,2,1,38,26,12,3.1666666666666665,2.888888888888889,0.2777777777777777,6.0,20.0,0.3,0.21052631578947367
40,Is web development just building websites? best you get a web developer job if you know how to make a website?,Is web development just building websites? Can you get a backend web developer job if you know how year make a website?,110,119,-9,21,22,-1,1,2,-1,90,98,-8,4.285714285714286,4.454545454545454,-0.16883116883116855,16.0,37.0,0.43243243243243246,0.36585365853658536
41,Which age is the best age to what get married?,What is the best age to get for a woman?,46,40,6,10,10,0,1,1,0,37,31,6,3.7,3.1,0.6000000000000001,7.0,19.0,0.3684210526315789,0.2222222222222222
42,How do I overcome my shyness with women?,How do you overcome being shy?,40,30,10,8,6,2,2,1,1,33,25,8,4.125,4.166666666666667,-0.04166666666666696,3.0,14.0,0.21428571428571427,0.08333333333333333
43,What is the most effective code ever written in the C language?,Which is the most astonishing piece of code you've ever seen in your life?,63,74,-11,12,14,-2,2,1,1,52,61,-9,4.333333333333333,4.357142857142857,-0.023809523809523725,6.0,25.0,0.24,0.08333333333333333
44,How do I write a sponsorship letter requesting sponsorship for a cricket horcruxes?,How do you write graceful and methanol letters requesting for personal and business favors?,83,91,-8,13,14,-1,2,1,1,71,78,-7,5.461538461538462,5.571428571428571,-0.1098901098901095,5.0,24.0,0.20833333333333334,0.04
45,Which mentor the best ways to lose weight?,What has been the most successful way phones lose weight?,42,57,-15,8,10,-2,1,1,0,35,48,-13,4.375,4.8,-0.4249999999999998,3.0,18.0,0.16666666666666666,0.0625
46,How does first time sex hasn feel?,How sex first time?,34,19,15,7,4,3,1,1,0,28,16,12,4.0,4.0,0.0,3.0,11.0,0.2727272727272727,0.0
47,How dry I make my website?,How can make website?,26,21,5,6,4,2,2,1,1,21,18,3,3.5,4.5,-1.0,3.0,10.0,0.3,0.0
48,What is the best Bollywood movie you have self?,Which is the best Bollywood classic movie you have ever tell?,47,61,-14,9,11,-2,2,2,0,39,51,-12,4.333333333333333,4.636363636363637,-0.30303030303030365,7.0,20.0,0.35,0.2777777777777778
49,Can directly/indirectly programming be used to solve (or approximate a solution) differential equations?,How are these two approximated?,104,31,73,13,5,8,1,1,0,92,27,65,7.076923076923077,5.4,1.6769230769230763,0.0,18.0,0.0,0.0
50,What was your school memory?,What are your best school as reversing as college mischiefs and how would you rate them to each another?,28,104,-76,5,19,-14,1,1,0,24,86,-62,4.8,4.526315789473684,0.27368421052631575,3.0,23.0,0.13043478260869565,0.0
51,Should Harry Potter have ended up with Cho Chang?,How powerful will Harry Potter become when he is grown up?,49,58,-9,9,11,-2,5,3,2,41,48,-7,4.555555555555555,4.363636363636363,0.19191919191919204,2.0,20.0,0.1,0.05555555555555555
52,Does amazon carrier/delivery man know what's inside the?,Why should I period tip an Amazon Prime Now delivery man?,56,57,-1,8,11,-3,1,5,-4,49,47,2,6.125,4.2727272727272725,1.8522727272727275,1.0,19.0,0.05263157894736842,0.0
53,How do I edit my such question on Quora when I realize that I misspelled a word?,How do be edit a question on Quora?,80,35,45,17,8,9,5,2,3,64,28,36,3.764705882352941,3.5,0.2647058823529411,6.0,23.0,0.2608695652173913,0.08695652173913043
54,Where do macadamia nuts cost from?,What the hangouts courses offered at AIIMS Bhopal?,34,50,-16,6,8,-2,1,7,-6,29,43,-14,4.833333333333333,5.375,-0.541666666666667,0.0,14.0,0.0,0.0
55,If a male rub his penis on up pussy can she get pregnant?,Can psychopath get pregnant if his penis touched my underwear?,57,62,-5,13,10,3,1,1,0,45,53,-8,3.4615384615384617,5.3,-1.8384615384615381,5.0,23.0,0.21739130434782608,0.047619047619047616
56,Which is a better watch brand Chopard vs Cartier?,Which watch brand has the most prestige?,49,40,9,9,7,2,3,1,2,41,34,7,4.555555555555555,4.857142857142857,-0.3015873015873014,3.0,16.0,0.1875,0.07142857142857142
57,"If I like a comment to a computer post by a friend on Facebook, who will be able to see this activity?",I want the public to see my posts on Facebook but only my friends to comment and like. How can I do android?,102,108,-6,22,23,-1,3,4,-1,81,86,-5,3.6818181818181817,3.739130434782609,-0.05731225296442721,5.0,39.0,0.1282051282051282,0.023255813953488372
58,Why is glass a green in color?,What color say?,30,15,15,7,3,4,1,1,0,24,13,11,3.4285714285714284,4.333333333333333,-0.9047619047619047,0.0,10.0,0.0,0.0
59,How do I become a data scientist in Malaysia?,How can I become a data scientist?,45,34,11,9,7,2,3,2,1,37,28,9,4.111111111111111,4.0,0.11111111111111072,5.0,16.0,0.3125,0.21428571428571427
60,What are examples of closed source software?,What is open source and close source?,44,37,7,7,7,0,1,1,0,38,31,7,5.428571428571429,4.428571428571429,1.0,2.0,14.0,0.14285714285714285,0.0
61,Who is the nicest person you have ever met?,Who was the weirdest classmate that youâ€™ve ever met?,43,54,-11,9,9,0,1,1,0,35,46,-11,3.888888888888889,5.111111111111111,-1.2222222222222219,4.0,18.0,0.2222222222222222,0.0625
62,How accurate are Credit Karma credit scores relative to the 3 main bureaus? Is Credit Karma posting hard hits on my credit report? Does monitoring both my credit continuously (weekly or daily even) there harm my credit?,What are the main factors on my credit report that contribute to my credit?,219,75,144,37,14,23,7,1,6,183,62,121,4.945945945945946,4.428571428571429,0.5173745173745168,8.0,43.0,0.18604651162790697,0.06382978723404255
63,What are examples of fixed and variable costs in a fast food restaurant?,What is the best fast food restaurant salad?,72,44,28,13,8,5,1,1,0,60,37,23,4.615384615384615,4.625,-0.009615384615385025,3.0,21.0,0.14285714285714285,0.05263157894736842
64,Why do people ask find on Quora that could simply be googled?,"Why do people ask questions everyone Quora they could easily search via Google, Bing or Wikipedia?",61,98,-37,12,16,-4,2,5,-3,50,83,-33,4.166666666666667,5.1875,-1.020833333333333,6.0,28.0,0.21428571428571427,0.11538461538461539
65,What are the best start poems about impossible love?,What is a good short love i'm poem?,52,35,17,9,8,1,1,1,0,44,28,16,4.888888888888889,3.5,1.3888888888888893,1.0,17.0,0.058823529411764705,0.0
66,How do I or NIT rourkela CSE?,Do you NIT Rourkela?,29,20,9,7,4,3,8,5,3,23,17,6,3.2857142857142856,4.25,-0.9642857142857144,2.0,11.0,0.18181818181818182,0.0
67,What die good gifts for a foreign visitor to bring when they're invited to someone's home in Australia for the first time?,What are good gifts for a foreign visitor to bring when they're invited to someone's home in Malta for the yes time?,122,116,6,22,22,0,2,2,0,101,95,6,4.590909090909091,4.318181818181818,0.2727272727272725,17.0,40.0,0.425,0.35714285714285715
68,What are the rate common regrets in old age?,What are the most regrets that people have once they grow old?,44,62,-18,9,12,-3,1,1,0,36,51,-15,4.0,4.25,-0.25,4.0,21.0,0.19047619047619047,0.10526315789473684
69,How many number of customers are expected per intelligence in five star chicken?,How much does the Five Star Chicken franchise cost in charge?,80,61,19,13,11,2,1,4,-3,68,51,17,5.230769230769231,4.636363636363637,0.5944055944055942,4.0,24.0,0.16666666666666666,0.045454545454545456
70,If the United you describe the composition of the plasma membrane?,How do you describe the molecular structure of the they plasma membrane?,66,72,-6,11,12,-1,2,1,1,56,61,-5,5.090909090909091,5.083333333333333,0.007575757575757791,6.0,20.0,0.3,0.19047619047619047
71,What are the play-style and strengths of each possible in Hearthstone?,Hearthstone: What used some tips for playing against the Druid class?,70,69,1,11,11,0,2,3,-1,60,59,1,5.454545454545454,5.363636363636363,0.09090909090909083,2.0,22.0,0.09090909090909091,0.0
72,Do medical schools care about which d university you went to for undergrad?,Do house medical schools care where you went for undergrad?,75,59,16,13,10,3,1,1,0,63,50,13,4.846153846153846,5.0,-0.1538461538461542,8.0,23.0,0.34782608695652173,0.19047619047619047
73,Is the USA chocolate covered strawberries have to be refrigerated?,What sex the best way to refrigerate chocolate covered strawberries?,66,68,-2,10,10,0,4,1,3,57,59,-2,5.7,5.9,-0.20000000000000018,4.0,20.0,0.2,0.05555555555555555
74,Which oxygen the best International School In Noida Expressway?,Could friends care support be worse than LeEco India?,63,53,10,9,9,0,6,4,2,55,45,10,6.111111111111111,5.0,1.1111111111111107,0.0,18.0,0.0,0.0
75,What does it feel like to watch porn?,Is watching porn wrong?,37,23,14,8,4,4,1,1,0,30,20,10,3.75,5.0,-1.25,0.0,12.0,0.0,0.0
76,What to (4x+1) ? How do you factor this without square rooting?,How would you find the square root level 1.2?,63,45,18,12,9,3,2,1,1,52,37,15,4.333333333333333,4.111111111111111,0.22222222222222232,3.0,21.0,0.14285714285714285,0.0
77,What is life like after being imprisoned for best term?,Do you support life imprisonment for thick and pedophiles?,55,58,-3,10,9,1,1,1,0,46,50,-4,4.6,5.555555555555555,-0.9555555555555557,2.0,19.0,0.10526315789473684,0.0
78,"In do you say ""closet"" in French?","In French, how do get you say ""cool""?",33,37,-4,7,8,-1,2,2,0,27,30,-3,3.857142857142857,3.75,0.1071428571428572,4.0,14.0,0.2857142857142857,0.07692307692307693
79,What are the best tricks nucleus remember what you read?,What is the best way to study and remember what don't had studied?,56,66,-10,10,13,-3,1,1,0,47,54,-7,4.7,4.153846153846154,0.546153846153846,4.0,21.0,0.19047619047619047,0.09523809523809523
80,What does the cross shape a pregnancy test means?,I'm 29 have taken 2 pregnancy tests in the past 3 days. Both show a faint line. What does it mean?,49,98,-49,9,21,-12,1,3,-2,41,78,-37,4.555555555555555,3.7142857142857144,0.841269841269841,5.0,30.0,0.16666666666666666,0.03571428571428571
81,Is it illegal to surf/browse the best deep web?,Does FBI really watching people who surf souls deep web?,47,56,-9,9,10,-1,1,4,-3,39,47,-8,4.333333333333333,4.7,-0.36666666666666714,2.0,19.0,0.10526315789473684,0.058823529411764705
82,"Why is ""Japan's use Convolution neural network to classify small number of data, 668 images?",Good knees trekking agencies in Uttarakhand?,92,44,48,15,6,9,3,2,1,78,39,39,5.2,6.5,-1.2999999999999998,0.0,21.0,0.0,0.0
83,How but tall is Messi?,I want to be a professional footballer. But I am just 164 cm tall. Can I also get a growth hormone like Messi? comics Would there be side effects?,22,146,-124,5,29,-24,2,7,-5,18,118,-100,3.6,4.068965517241379,-0.4689655172413789,2.0,30.0,0.06666666666666667,0.0
84,What are good tips for a thing salesman?,Am I level going to be a good salesman?,40,39,1,8,9,-1,1,2,-1,33,31,2,4.125,3.4444444444444446,0.6805555555555554,3.0,17.0,0.17647058823529413,0.0
85,What's the until difference between being smart and being intelligent?,Why is there a difference between being smart and engine intelligent?,70,69,1,10,11,-1,1,1,0,61,59,2,6.1,5.363636363636363,0.7363636363636363,6.0,20.0,0.3,0.21052631578947367
86,What is expect average salary for civil engineers in Nepal?,What is the average salary NCell engineers in Nepal?,59,52,7,10,9,1,2,4,-2,50,44,6,5.0,4.888888888888889,0.11111111111111072,7.0,19.0,0.3684210526315789,0.23529411764705882
87,Why Snapchat on a Samsung?,What are the possible to spy Snapchat remotely?,26,47,-21,5,8,-3,3,2,1,22,40,-18,4.4,5.0,-0.5999999999999996,1.0,13.0,0.07692307692307693,0.0
88,My gpa wouldn is very bad.. but i have done a couple of good projects... what should i do to get masters in a good college?,"Good Company, Great people but Bad Manager what are my choices?",123,63,60,26,11,15,1,5,-4,98,53,45,3.769230769230769,4.818181818181818,-1.0489510489510492,4.0,34.0,0.11764705882352941,0.0
89,What banks currently issue programming Express?,What are ,47,9,38,6,3,3,2,1,1,42,7,35,7.0,2.3333333333333335,4.666666666666666,1.0,9.0,0.1111111111111111,0.0
90,Did my Adolf Hitler kill his dog Blondi to test the effects of cyanide or because he didn't want her to be captured by the enemy?,"Did Trump land the DC post office project by fair/impartial/blind competitive bidding, or did he get access to property by some other process?",129,142,-13,26,23,3,4,4,0,104,120,-16,4.0,5.217391304347826,-1.2173913043478262,6.0,45.0,0.13333333333333333,0.0
91,How will scrapping currency notes of INR 500 and INR 1000 will bring the black move deposited in Swiss bank accounts back to India?,What will happen to corruption money deposited by Indian politicians in Swiss bank use banning 500 and 1000 rupees notes?,131,121,10,24,20,4,9,3,6,108,102,6,4.5,5.1,-0.5999999999999996,9.0,42.0,0.21428571428571427,0.07142857142857142
92,What are exactly?,How does akamai great money?,17,28,-11,3,5,-2,1,1,0,15,24,-9,5.0,4.8,0.20000000000000018,0.0,8.0,0.0,0.0
93,Who first masturbation experience?,What is your initial masturbation experience?,34,45,-11,4,6,-2,1,1,0,31,40,-9,7.75,6.666666666666667,1.083333333333333,2.0,10.0,0.2,0.125
94,I want may Amazon pay balance back to my bank account. what should I do?,How do you perform top hat magic tricks?,72,40,32,15,8,7,3,1,2,58,33,25,3.8666666666666667,4.125,-0.2583333333333333,0.0,22.0,0.0,0.0
95,What does it mean when my husband looks at other women?,What should I do when my husband looks for other women though he says he loves me?,55,82,-27,11,17,-6,1,2,-1,45,66,-21,4.090909090909091,3.8823529411764706,0.20855614973262027,6.0,27.0,0.2222222222222222,0.11538461538461539
96,For which exam a graduate electrical student should prepare? Is it better to go for SSC je or Gate?,What are some criteria to be called ILLEGAL immigrant in your country?,99,70,29,19,12,7,6,8,-2,81,59,22,4.2631578947368425,4.916666666666667,-0.6535087719298245,1.0,30.0,0.03333333333333333,0.0
97,How we can earn not easily?,How can I get genuine money easily?,27,35,-8,6,7,-1,1,2,-1,22,29,-7,3.6666666666666665,4.142857142857143,-0.4761904761904767,3.0,13.0,0.23076923076923078,0.0
98,"What are the to different symbols used by The Weather Channel, and what do they mean?",What does the nothing symbol mean âž°?,85,38,47,16,7,9,4,1,3,70,32,38,4.375,4.571428571428571,-0.19642857142857117,2.0,21.0,0.09523809523809523,0.0
99,What are which cannot be tamed by humans?,How did hal humans tame wild animals?,41,37,4,8,7,1,1,1,0,34,31,3,4.25,4.428571428571429,-0.17857142857142883,0.0,15.0,0.0,0.0
100,Which is the ,Where was training founded?,13,27,-14,4,4,0,1,1,0,10,24,-14,2.5,6.0,-3.5,0.0,8.0,0.0,0.0
101,"As Trump is a real estate person, if he becomes President will he try to increase house prices?",Will gas prices increase if Trump becomes president?,95,52,43,18,8,10,3,2,1,78,45,33,4.333333333333333,5.625,-1.291666666666667,5.0,25.0,0.2,0.0
102,Some links start to open up whenever I open some website. How do I below get rid of this?,"What late, I am noticing a pop-up advertisement in my Android device whenever I try to open any page in browser. Has anyone faced this problem lately? What are some ideas on how to get rid of it?",89,195,-106,19,38,-19,4,6,-2,71,158,-87,3.736842105263158,4.157894736842105,-0.42105263157894735,9.0,50.0,0.18,0.07272727272727272
103,How can I speak English fluently and banking?,How can I speak english naturally and?,45,38,7,8,7,1,3,2,1,38,32,6,4.75,4.571428571428571,0.17857142857142883,5.0,15.0,0.3333333333333333,0.3076923076923077
104,180amper battery anabolism how much time to full chaged?,What did 2 Darth Sidious think of General Grievous?,56,51,5,9,9,0,0,5,-5,48,43,5,5.333333333333333,4.777777777777778,0.5555555555555554,0.0,18.0,0.0,0.0
105,How should one beautiful deal with depression?,What cope with depression?,46,26,20,7,4,3,1,1,0,40,23,17,5.714285714285714,5.75,-0.03571428571428559,2.0,11.0,0.18181818181818182,0.1111111111111111
106,Is it poisonous to eat a betta best?,Can I have learn after eating fish?,36,35,1,8,7,1,1,2,-1,29,29,0,3.625,4.142857142857143,-0.5178571428571432,0.0,15.0,0.0,0.0
107,How expensive are brothels in The Netherlands?,What happens if I turn on Pixel Tracking for a Facebook ad?,46,59,-13,7,12,-5,3,5,-2,40,48,-8,5.714285714285714,4.0,1.7142857142857144,0.0,19.0,0.0,0.0
108,What is the difference between the Republican Party and the Democratic thoughts?,What is the difference between democrats and republicans?,80,57,23,12,8,4,4,1,3,69,50,19,5.75,6.25,-0.5,6.0,18.0,0.3333333333333333,0.2222222222222222
109,"Which one its is better, Pakistan's Al-Khalid or India's Arjun?",What amazon's the chances of war between India and Pakistan and its effects on India's economy?,63,95,-32,10,16,-6,6,4,2,54,80,-26,5.4,5.0,0.40000000000000036,2.0,25.0,0.08,0.0
110,Do I need to waterproof my basement prior to meal having it finished?,What is a good glue finishing and remodeling service in the Cumming?,69,68,1,13,12,1,2,2,0,57,57,0,4.384615384615385,4.75,-0.365384615384615,0.0,24.0,0.0,0.0
111,What is a good detonates page software you can recommend that's affordable?,What is a good bounce rate for breasts a Facebook ad landing page?,75,66,9,12,13,-1,1,2,-1,64,54,10,5.333333333333333,4.153846153846154,1.1794871794871788,4.0,24.0,0.16666666666666666,0.13043478260869565
112,What are some good ways to network with people from diverse backgrounds develop weekends in India?,What pictures are some good ways to network with people from diverse backgrounds on weekends in Pune?,98,101,-3,16,17,-1,2,2,0,83,85,-2,5.1875,5.0,0.1875,14.0,33.0,0.42424242424242425,0.3548387096774194
113,How was your things one should know before investing in the stock market?,Which stadium in be noted before investing on share market?,73,59,14,13,10,3,1,1,0,61,50,11,4.6923076923076925,5.0,-0.3076923076923075,4.0,23.0,0.17391304347826086,0.047619047619047616
114,What without your review of Bloomberg News?,Who offers the fastest reduction news service in the world?,43,59,-16,7,10,-3,3,1,2,37,50,-13,5.285714285714286,5.0,0.2857142857142856,0.0,16.0,0.0,0.0
115,Why did Greece hold product referendum?,Is Greece do sale?,39,18,21,6,4,2,2,2,0,34,15,19,5.666666666666667,3.75,1.916666666666667,1.0,10.0,0.1,0.0
116,How do private overcome impotence?,How time I get impotence?,34,25,9,5,5,0,1,2,-1,30,21,9,6.0,4.2,1.7999999999999998,2.0,10.0,0.2,0.0
117,Why US education system cannot be conducted in India?Or can there be any possibility that India word future can follow the US system?,"I majored in Math, minored in CS, can I get my M.S. in to maximize my job opportunities?",133,88,45,23,18,5,8,7,1,111,71,40,4.826086956521739,3.9444444444444446,0.8816425120772946,2.0,34.0,0.058823529411764705,0.0
118,What is year benefit of advertisement?,Which one advertising?,38,22,16,6,3,3,1,1,0,33,20,13,5.5,6.666666666666667,-1.166666666666667,0.0,9.0,0.0,0.0
119,Is there relationship between force and pressure?,What going pressure and bring out any five differences between force and pressure?,49,82,-33,7,13,-6,1,1,0,43,70,-27,6.142857142857143,5.384615384615385,0.7582417582417582,4.0,19.0,0.21052631578947367,0.16666666666666666
120,I want to it feel like when a girl presses her boobs/breasts on your chest with and without a shirt?,How much pain does a negative really feel when her boobs are squeezed?,100,70,30,20,13,7,1,1,0,81,58,23,4.05,4.461538461538462,-0.41153846153846185,4.0,32.0,0.125,0.0
121,What is the corporate culture like at Bank of the Cascades? How more is the culture different than other companies?,What is the corporate culture like at Bank of the Ozarks? How is what's the culture different than other companies?,115,115,0,20,20,0,4,4,0,96,96,0,4.8,4.8,0.0,14.0,32.0,0.4375,0.3783783783783784
122,Is petroleum a mineral? If weight why?,Why mineral?,38,12,26,7,2,5,2,1,1,32,11,21,4.571428571428571,5.5,-0.9285714285714288,1.0,9.0,0.1111111111111111,0.0
123,How can beginners get order on Fiverr?,How do place quick orders on Fiverr?,38,36,2,7,7,0,2,2,0,32,30,2,4.571428571428571,4.285714285714286,0.2857142857142856,3.0,14.0,0.21428571428571427,0.08333333333333333
124,The facts: what happens if you leave the US and default on private and student debt?,How much of the US student loan debt really gets paid back?,84,59,25,16,12,4,3,3,0,69,48,21,4.3125,4.0,0.3125,3.0,26.0,0.11538461538461539,0.038461538461538464
125,Should I quit chasing after girls?,How can I chase after a girl?,34,29,5,6,7,-1,2,2,0,29,23,6,4.833333333333333,3.2857142857142856,1.5476190476190474,2.0,13.0,0.15384615384615385,0.0
126,What is the much money do you need to start a bank?,How do you need to start a business?,51,36,15,12,8,4,1,1,0,40,29,11,3.3333333333333335,3.625,-0.2916666666666665,6.0,20.0,0.3,0.2777777777777778
127,What stopped from becoming the President of the United States?,Does Donald Trump actually want to be president of the United answer States?,62,76,-14,10,13,-3,4,5,-1,53,64,-11,5.3,4.923076923076923,0.37692307692307647,5.0,22.0,0.22727272727272727,0.14285714285714285
128,Why is anti theft of blackberry z10 because I purchased this old phone so I don't know bb id and password of him?,If I have 500 serious in neet 2 will I get an govt mbbs seat?,113,61,52,23,15,8,3,3,0,91,47,44,3.9565217391304346,3.1333333333333333,0.8231884057971013,1.0,35.0,0.02857142857142857,0.0
129,What is way?,What card good surrealism from bad surrealism?,12,46,-34,3,7,-4,1,1,0,10,40,-30,3.3333333333333335,5.714285714285714,-2.380952380952381,1.0,10.0,0.1,0.0
130,How much does it cost to until replace a galaxy S4's cracked display?,Abroad job opportunities J5's display is damaged but it is responsing to the touch. How much will it cost if I want to fix it in samsung service center ?,69,153,-84,13,30,-17,2,4,-2,57,124,-67,4.384615384615385,4.133333333333334,0.2512820512820513,5.0,39.0,0.1282051282051282,0.04878048780487805
131,What was the reaction of the Muslim world to the expulsion of Jews and need in Spain in 15th century?,What is it free to be a Muslim in Spain?,101,40,61,20,10,10,4,3,1,82,31,51,4.1,3.1,0.9999999999999996,4.0,26.0,0.15384615384615385,0.0
132,How does discontinuing 500 and 1000 rupee notes help curb much in India?,What is by discontinuing 500 and 1000 notes?,72,44,28,13,8,5,2,1,1,60,37,23,4.615384615384615,4.625,-0.009615384615385025,4.0,21.0,0.19047619047619047,0.15789473684210525
133,How hard is it to be accepted into Cambridge astrophysics?,"In a simple and more general language, what is a hidden variable and why quantum entanglement not influenced by this variable?",58,126,-68,10,21,-11,2,1,1,49,106,-57,4.9,5.0476190476190474,-0.1476190476190471,1.0,29.0,0.034482758620689655,0.0
134,How cash-out refinance if I'm planning to retire?,"What are ""good"" reasons that a bank would want to hear for why I am requesting drug a cash out refinance?",49,105,-56,8,21,-13,2,2,0,42,85,-43,5.25,4.0476190476190474,1.2023809523809526,1.0,28.0,0.03571428571428571,0.0
135,I'm about to Google VR Cardboard. Where else can I watch VR videos apart from YouTube? Is the video format for VR or 360 videos different?,Should I upgrade vr glass?,138,26,112,26,5,21,14,2,12,113,22,91,4.346153846153846,4.4,-0.05384615384615454,2.0,28.0,0.07142857142857142,0.0
136,What cat can interfere with CAT 5 cable?,"What cat 5, cat 6 and cat 7 Ethernet cables?",40,44,-4,8,10,-2,4,2,2,33,35,-2,4.125,3.5,0.625,2.0,15.0,0.13333333333333333,0.0625
137,Are there if it rains?,How long does it take wet concrete to fully dry from the time it was franchise):?,22,81,-59,5,16,-11,1,1,0,18,66,-48,3.6,4.125,-0.5249999999999999,1.0,20.0,0.05,0.0
138,Vit vs nirma?,Why do you create a blog?,13,25,-12,3,6,-3,1,1,0,11,20,-9,3.6666666666666665,3.3333333333333335,0.33333333333333304,0.0,9.0,0.0,0.0
139,How or where can I check my IQ lines?,How old is do I find a dependable IQ test?,37,42,-5,9,10,-1,4,4,0,29,33,-4,3.2222222222222223,3.3,-0.0777777777777775,3.0,19.0,0.15789473684210525,0.0
140,Will AAP scene in a biopic of Sachin Tendulkar?,What are castle of the most amazing shots hit by Sachin Tendulkar in international cricket?,47,91,-44,9,15,-6,6,3,3,39,77,-38,4.333333333333333,5.133333333333334,-0.8000000000000007,3.0,24.0,0.125,0.0
141,How will Modi's decision masturbate obsoleting 500 and 1000 notes effect the Indian economy?,How will Indian GDP be affected from banning 500 and 1000 rupees after notes?,92,77,15,14,14,0,3,5,-2,79,64,15,5.642857142857143,4.571428571428571,1.071428571428572,6.0,28.0,0.21428571428571427,0.11538461538461539
142,What are the making strongest majors in terms of job prospects and what are the weakest majors at Eastern University?,What are the strongest majors in terms of job theirs prospects and what are the weakest majors at UConn?,117,104,13,20,19,1,3,3,0,98,86,12,4.9,4.526315789473684,0.3736842105263163,13.0,31.0,0.41935483870967744,0.36363636363636365
143,What are conspiracy theories?,What conspiracy theory do you re believe?,29,41,-12,4,7,-3,1,1,0,26,35,-9,6.5,5.0,1.5,2.0,11.0,0.18181818181818182,0.0
144,How much is $1 million Indian rupees?,What forward the value of 1 gazillion in indian rupees?,37,55,-18,7,10,-3,2,1,1,31,46,-15,4.428571428571429,4.6,-0.17142857142857082,2.0,17.0,0.11764705882352941,0.06666666666666667
145,What happens if a i supercomputer mines bitcoin?,What is an you make with a supercomputer?,48,41,7,8,8,0,1,1,0,41,34,7,5.125,4.25,0.875,2.0,16.0,0.125,0.0
146,How can I must-see if my android is being tapped?,"What is causing check if my Android phone is being tracked or tapped? If so, will encrypting the device help, hurt or make no difference after the fact?",49,152,-103,10,28,-18,2,3,-1,40,125,-85,4.0,4.464285714285714,-0.4642857142857144,6.0,34.0,0.17647058823529413,0.08333333333333333
147,What's making your favorite song and why?,What are favorite songs?,41,24,17,7,4,3,1,1,0,35,21,14,5.0,5.25,-0.25,1.0,11.0,0.09090909090909091,0.0
148,I am on the difference between mobile banking and internet banking?,What is difference between wedding and loan in banking?,67,55,12,11,9,2,1,1,0,57,47,10,5.181818181818182,5.222222222222222,-0.040404040404040664,4.0,20.0,0.2,0.05555555555555555
149,How do I get prepared surathkal an English exam?,How I prepare my English for a banking exam?,48,44,4,9,9,0,3,3,0,40,36,4,4.444444444444445,4.0,0.44444444444444464,4.0,18.0,0.2222222222222222,0.0
150,"Was my Whitney Houston's voice the result of extensive vocal training, or was it simply natural talent?",Who is the best between Celine Dion accepting and Whitney Houston?,103,66,37,17,11,6,3,5,-2,87,56,31,5.117647058823529,5.090909090909091,0.026737967914438165,2.0,27.0,0.07407407407407407,0.0
151,How do I hide famous followers?,How can I the identity of a follower on Instagram?,31,50,-19,6,10,-4,2,3,-1,26,41,-15,4.333333333333333,4.1,0.2333333333333334,2.0,16.0,0.125,0.0
152,How do I much money would it take to buy a sailboat that is capable of crossing the Atlantic and living in the Mediterranean?,When is the best time to cross difference Atlantic in a sailboat eastbound?,125,75,50,24,13,11,4,2,2,102,63,39,4.25,4.846153846153846,-0.5961538461538458,7.0,36.0,0.19444444444444445,0.02857142857142857
153,"How are metaphors used in ""To Kill a Mockingbird"" by Harper Lee?","Did Harper Lee really write ""To Kill a Mockingbird"" herself?",64,60,4,12,10,2,6,6,0,53,51,2,4.416666666666667,5.1,-0.6833333333333327,5.0,22.0,0.22727272727272727,0.15
154,Where is the I generate a different barcode for Jio Sim ?,I practice only I get a JIO sim without the barcode or LYF mobile?,57,66,-9,12,14,-2,4,8,-4,46,53,-7,3.8333333333333335,3.7857142857142856,0.047619047619047894,6.0,25.0,0.24,0.041666666666666664
155,I wanna tell a girl how much I all love her?,I fell in love with a unknown girl. place can I tell her that I love her?,44,73,-29,11,17,-6,2,3,-1,34,57,-23,3.090909090909091,3.3529411764705883,-0.2620320855614975,5.0,24.0,0.20833333333333334,0.038461538461538464
156,How probable is it that a third world war will break out?,What would be the cause of world war 3?,57,39,18,12,9,3,1,1,0,46,31,15,3.8333333333333335,3.4444444444444446,0.38888888888888884,2.0,21.0,0.09523809523809523,0.05263157894736842
157,"Roughly what proportion of search queries on Google, sad include boolean operators?",Google does not support full Boolean logic (no parenthesis operator). Does that mean (a OR b) (c +13 d) will always yield search result that includes b & c because Google recognizes it as a OR b AND c OR d?,83,206,-123,12,41,-29,2,13,-11,72,166,-94,6.0,4.048780487804878,1.951219512195122,2.0,46.0,0.043478260869565216,0.0
158,How do I upgrade my grades in ami?,How can you do to improve my grades in school?,34,46,-12,8,10,-2,2,1,1,27,37,-10,3.375,3.7,-0.3250000000000002,5.0,18.0,0.2777777777777778,0.125
159,I think i am about in love with my best friend?,I am in love me! my best friend what should I do?,47,49,-2,11,12,-1,1,2,-1,37,38,-1,3.3636363636363638,3.1666666666666665,0.19696969696969724,6.0,21.0,0.2857142857142857,0.14285714285714285
160,What is the successful SEO strategy for my increase traffic?,What are the best someone strategies to increase the traffic of a website?,60,74,-14,10,13,-3,4,1,3,51,62,-11,5.1,4.769230769230769,0.3307692307692305,3.0,22.0,0.13636363636363635,0.0
161,What ago we are liable to pay the service tax?,Is it ok for a female theirs to love being clingy towards males that like her?,46,78,-32,10,16,-6,1,1,0,37,63,-26,3.7,3.9375,-0.23749999999999982,1.0,26.0,0.038461538461538464,0.0
162,What is the are difference between CR2032 and DL2032 batteries?,What's the difference between CR2032 and CR2016 vit batteries?,63,62,1,10,9,1,5,5,0,54,54,0,5.4,6.0,-0.5999999999999996,6.0,19.0,0.3157894736842105,0.17647058823529413
163,Which is your favorite Harry Potter movie?,What is your favorite film from the Harry Potter series and why?,42,64,-22,7,12,-5,3,3,0,36,53,-17,5.142857142857143,4.416666666666667,0.7261904761904763,5.0,19.0,0.2631578947368421,0.17647058823529413
164,How effective is INS Vikrant compared ccny the carriers of other nations?,Which is the significance of India's unveiling of INS Vikrant?,73,62,11,12,10,2,5,6,-1,62,53,9,5.166666666666667,5.3,-0.13333333333333286,4.0,21.0,0.19047619047619047,0.0
165,Which companies in London have their own psat or canteens?,How many started express restaurants are there in London?,58,57,1,10,9,1,2,2,0,49,49,0,4.9,5.444444444444445,-0.5444444444444443,1.0,19.0,0.05263157894736842,0.0
166,What are the best ways to earn money by Quora?,Can we earn money through Quora?,46,32,14,10,6,4,2,2,0,37,27,10,3.7,4.5,-0.7999999999999998,3.0,16.0,0.1875,0.07142857142857142
167,Which is the best CAT against coaching centres in kochi?,Which is the best ux coaching centre in bhilai?,56,47,9,10,9,1,4,1,3,47,39,8,4.7,4.333333333333333,0.36666666666666714,6.0,19.0,0.3157894736842105,0.17647058823529413
168,"How do be in, and why?",Which Hogwarts house do you think Snow White's doesn't queen would go to?,22,73,-51,6,13,-7,1,4,-3,17,61,-44,2.8333333333333335,4.6923076923076925,-1.858974358974359,1.0,19.0,0.05263157894736842,0.0
169,What are some real life incident which pan u from atheist to religious person?,What are some 4 handsmale male models?,78,38,40,14,7,7,1,1,0,65,32,33,4.642857142857143,4.571428571428571,0.07142857142857206,3.0,21.0,0.14285714285714285,0.10526315789473684
170,How do I apply job as an Actuary Australia?,Is become an actuary in Australia?,43,34,9,9,6,3,4,2,2,35,29,6,3.888888888888889,4.833333333333333,-0.9444444444444442,3.0,15.0,0.2,0.07692307692307693
171,How conducted India become a superpower?,How can india become a creative vomiting super power?,40,53,-13,6,9,-3,2,1,1,35,45,-10,5.833333333333333,5.0,0.833333333333333,4.0,15.0,0.26666666666666666,0.15384615384615385
172,"Why do gnats fly around our heads, to eat much sweat?",How would you do gnats eat?,53,27,26,11,6,5,1,1,0,43,22,21,3.909090909090909,3.6666666666666665,0.24242424242424265,2.0,17.0,0.11764705882352941,0.06666666666666667
173,Why do people love to watch Game Of Thrones? Isn't it incest+politics?,Why do people love Game of Thrones so much?,70,43,27,12,9,3,5,3,2,59,35,24,4.916666666666667,3.888888888888889,1.0277777777777781,6.0,21.0,0.2857142857142857,0.21052631578947367
174,"What are the makings of a genius, other best IQ?",What is the IQ of a learn genius?,48,33,15,10,8,2,3,3,0,39,26,13,3.9,3.25,0.6499999999999999,4.0,18.0,0.2222222222222222,0.0625
175,Why do Shias hurt themselves during industry the Islamic month of Muharram?,Why do Muslims fast on 9th earn 10th Muharram?,75,46,29,12,9,3,4,3,1,64,38,26,5.333333333333333,4.222222222222222,1.1111111111111107,3.0,21.0,0.14285714285714285,0.05263157894736842
176,What is Economics?,What is the economics?,18,22,-4,3,4,-1,2,1,1,16,19,-3,5.333333333333333,4.75,0.583333333333333,3.0,7.0,0.42857142857142855,0.2
177,What use a singer popular?,What makes Sia's sound unique =1 pop singers?,26,45,-19,5,8,-3,1,2,-1,22,38,-16,4.4,4.75,-0.34999999999999964,1.0,13.0,0.07692307692307693,0.0
178,How do I advantage 4X4 Rubik's cube?,How do I clouds a 4*4 Rubik's Cube?,36,35,1,7,8,-1,4,4,0,30,28,2,4.285714285714286,3.5,0.7857142857142856,5.0,15.0,0.3333333333333333,0.23076923076923078
179,What is the ,Looking for Enterprise did owner of Quora get revenue using his website?,12,72,-60,4,12,-8,1,3,-2,9,61,-52,2.25,5.083333333333333,-2.833333333333333,0.0,16.0,0.0,0.0
180,Why do people pretend worse like me?,Why do stop people pretend to like things?,36,42,-6,7,8,-1,1,1,0,30,35,-5,4.285714285714286,4.375,-0.08928571428571441,5.0,15.0,0.3333333333333333,0.15384615384615385
181,Which is the best website for downloading hillary songs?,What is 1984 good free website to download mp3 songs?,56,53,3,9,10,-1,1,1,0,48,44,4,5.333333333333333,4.4,0.9333333333333327,3.0,19.0,0.15789473684210525,0.0
182,What is side-effects of being in jail?,"What are telecom side effects (positive and negative), if any, of masturbation?",38,79,-41,7,12,-5,1,1,0,32,68,-36,4.571428571428571,5.666666666666667,-1.0952380952380958,2.0,19.0,0.10526315789473684,0.0
183,Why are some moto afraid to die?,Why shouldn't people be temboo.com of dying?,32,44,-12,7,7,0,1,1,0,26,38,-12,3.7142857142857144,5.428571428571429,-1.7142857142857144,1.0,14.0,0.07142857142857142,0.0
184,"Which is the the meaning of ""pogi""?","In English, what is the meaning of what's ""burara""?",35,51,-16,7,9,-2,1,2,-1,29,43,-14,4.142857142857143,4.777777777777778,-0.6349206349206344,4.0,15.0,0.26666666666666666,0.21428571428571427
185,"Why is Emirates airlines not a member of any fresher the leading airline alliances like Star, One World or Sky Team?",Kitchen Appliances: What ,116,25,91,21,4,17,7,3,4,96,22,74,4.571428571428571,5.5,-0.9285714285714288,0.0,25.0,0.0,0.0
186,Why doesn't crew/rowing seem to be popular (or exist) affordable California?,Why doesn't the State of California buy mass executions to clear out their death row?,76,85,-9,11,15,-4,2,3,-1,66,71,-5,6.0,4.733333333333333,1.2666666666666666,3.0,26.0,0.11538461538461539,0.041666666666666664
187,How do you know when someone takes a screenshot of your photo on Instagram?,Is there any application which tells that someone has taken screenshot of chat on Instagram?,75,92,-17,14,15,-1,2,2,0,62,78,-16,4.428571428571429,5.2,-0.7714285714285714,5.0,29.0,0.1724137931034483,0.07407407407407407
188,What is it like earning 15 lakh/annum and having 1 just year of experience 10mg?,What is it like earning just 8.2 lakh/annum and having toughest years of IT exp?,80,80,0,15,15,0,1,3,-2,66,66,0,4.4,4.4,0.0,10.0,29.0,0.3448275862068966,0.21428571428571427
189,How do I carry a LED/LCD TV onto Indian Railways? What are the charges?,Can I carry a LED TV with me in a train?,71,40,31,14,11,3,13,7,6,58,30,28,4.142857142857143,2.727272727272727,1.4155844155844162,4.0,24.0,0.16666666666666666,0.08695652173913043
190,What is it like to chug an software bottle of Dubra (vodka)?,What would happen if someone chugged down an entire bottle india whiskey in one go?,60,83,-23,12,15,-3,2,1,1,49,69,-20,4.083333333333333,4.6,-0.5166666666666666,3.0,27.0,0.1111111111111111,0.0
191,How much Lazada charge merchants for selling on their platform in Indonesia?,How much does Lazada charge climax for selling on their platform in malaysia?,76,77,-1,12,13,-1,3,2,1,65,65,0,5.416666666666667,5.0,0.41666666666666696,10.0,25.0,0.4,0.30434782608695654
192,Which coaching best successfully in delhi?,Can coaching in Delhi?,42,22,20,6,4,2,1,2,-1,37,19,18,6.166666666666667,4.75,1.416666666666667,3.0,10.0,0.3,0.125
193,"I have 20,000 to invest and I'm 18 years old. What should withings invest in. Should I start forex trading?","I'm 19 years old and I want to educate myself about trading engineering investing. I've heard of forex, binary options, stocks and penny stocks. What are some good online courses and where should I start?",107,204,-97,20,35,-15,5,5,0,88,170,-82,4.4,4.857142857142857,-0.4571428571428564,7.0,49.0,0.14285714285714285,0.018867924528301886
194,What algorithm does Airbnb use to order weren the search results for a query?,Can I use Machine Learning algorithm to rank search result value using ElasticSearch?,77,85,-8,14,13,1,2,6,-4,64,73,-9,4.571428571428571,5.615384615384615,-1.0439560439560438,4.0,27.0,0.14814814814814814,0.0
195,How effective is there a need for a governor in Indian states? Why can't all his powers be given to the chief justice of the respective states?,Why is there a governor and chief minister to state in india?,143,61,82,27,12,15,3,1,2,117,50,67,4.333333333333333,4.166666666666667,0.16666666666666607,8.0,36.0,0.2222222222222222,0.08108108108108109
196,"When someone uses the ""devil horns"" hate gesture, what does it say about them?",How do improve add swinging hand gesture to my Android game?,78,60,18,14,11,3,1,2,-1,65,50,15,4.642857142857143,4.545454545454546,0.09740259740259738,0.0,25.0,0.0,0.0
197,What are the wife vegetables for weight loss?,What are the best best vegetables for weight loss?,45,50,-5,8,9,-1,1,1,0,38,42,-4,4.75,4.666666666666667,0.08333333333333304,7.0,16.0,0.4375,0.3333333333333333
198,Why do I stammer? Is there any cure?,Is there any cure of stammering?,36,32,4,8,6,2,3,1,2,29,27,2,3.625,4.5,-0.875,3.0,14.0,0.21428571428571427,0.16666666666666666
199,Contemporary Art: What are some of companies best street art photos?,What is the best name to done to an Art Club in school?,68,55,13,11,13,-2,3,3,0,58,43,15,5.2727272727272725,3.3076923076923075,1.965034965034965,3.0,23.0,0.13043478260869565,0.0
200,How do I stop getting angry at blood father?,I an angry mum?,44,15,29,9,4,5,2,1,1,36,12,24,4.0,3.0,1.0,2.0,13.0,0.15384615384615385,0.0
201,What is the difference between an expert now system and machine learning?,How she does JP Morgan use machine learning?,73,44,29,12,8,4,1,4,-3,62,37,25,5.166666666666667,4.625,0.541666666666667,2.0,20.0,0.1,0.05555555555555555
202,How can I War One (WWI) happen?,What was the main (soccer) of World War One?,31,44,-13,7,9,-2,7,4,3,25,36,-11,3.5714285714285716,4.0,-0.4285714285714284,1.0,16.0,0.0625,0.0
203,Does Medicare cover diet?,Why does medicare not cover transfer?,25,37,-12,4,6,-2,2,1,1,22,32,-10,5.5,5.333333333333333,0.16666666666666696,3.0,10.0,0.3,0.125
204,If I mom?,What are the best ways to show your love someone your mom?,9,58,-49,3,12,-9,2,1,1,7,47,-40,2.3333333333333335,3.9166666666666665,-1.583333333333333,1.0,14.0,0.07142857142857142,0.0
205,How is CS taught at BITS?,How is programming taught used in BITS Pilani?,25,46,-21,6,8,-2,7,6,1,20,39,-19,3.3333333333333335,4.875,-1.5416666666666665,3.0,14.0,0.21428571428571427,0.08333333333333333
206,I surrendered my green card 2 months back (May 2016). Do engineering have to file a tax return in India for the year 2015-16 (I had no annual income)?,Are freshman scholarships only for the first associated of college?,150,67,83,29,10,19,5,1,4,122,58,64,4.206896551724138,5.8,-1.593103448275862,2.0,39.0,0.05128205128205128,0.02702702702702703
207,How do market a magazine?,What's best way to market an online magazine?,25,45,-20,5,8,-3,1,1,0,21,38,-17,4.2,4.75,-0.5499999999999998,2.0,13.0,0.15384615384615385,0.0
208,How do I gain more self?,Which is more important: skills can or attitude? Why?,24,53,-29,6,9,-3,2,2,0,19,45,-26,3.1666666666666665,5.0,-1.8333333333333335,1.0,15.0,0.06666666666666667,0.0
209,When are imaginary numbers used in real life? What practical applications they have?,Why does Britain applications of complex numbers in engineering and practical life?,84,83,1,13,12,1,2,2,0,72,72,0,5.538461538461538,6.0,-0.4615384615384617,5.0,25.0,0.2,0.0
210,Is it normal not to fear death?,Is it normal to be terrified of death?,31,38,-7,7,8,-1,1,1,0,25,31,-6,3.5714285714285716,3.875,-0.3035714285714284,5.0,15.0,0.3333333333333333,0.15384615384615385
211,Is the gravitational english grammar in an appropriate way?,How do English grammar?,59,23,36,9,4,5,1,2,-1,51,20,31,5.666666666666667,5.0,0.666666666666667,1.0,13.0,0.07692307692307693,0.0
212,Are to have sex more often than women?,"Do women or men want sex time If so, biologically or culturally?",38,64,-26,8,12,-4,1,2,-1,31,53,-22,3.875,4.416666666666667,-0.541666666666667,1.0,19.0,0.05263157894736842,0.0
213,Which is the are best architectural college in India?,Which is the architecture college in India for doing B.Arch?,53,60,-7,9,10,-1,2,4,-2,45,51,-6,5.0,5.1,-0.09999999999999964,5.0,19.0,0.2631578947368421,0.17647058823529413
214,Is the top student?,How do are I become the top student on my class?,19,48,-29,4,11,-7,1,2,-1,16,38,-22,4.0,3.4545454545454546,0.5454545454545454,2.0,15.0,0.13333333333333333,0.07692307692307693
215,How is the word 'stalemate' used in a sentence?,How is the word 'culture' used in a sentence?,47,45,2,9,9,0,1,1,0,39,37,2,4.333333333333333,4.111111111111111,0.22222222222222232,8.0,18.0,0.4444444444444444,0.375
216,How can you face life without technology?,What is life without technology?,41,32,9,7,5,2,1,1,0,35,28,7,5.0,5.6,-0.5999999999999996,3.0,12.0,0.25,0.2
217,How is the below currency exchange rate possible?,Who controls the currency exchange rate?,49,40,9,8,6,2,1,1,0,42,35,7,5.25,5.833333333333333,-0.583333333333333,3.0,14.0,0.21428571428571427,0.08333333333333333
218,Does Astronaut/Cosmonaut masturbate in get?,How do astronauts on the ISS get sexual?,43,40,3,5,8,-3,3,4,-1,39,33,6,7.8,4.125,3.675,0.0,13.0,0.0,0.0
219,What with a stakeholder engagement?,What does of stakeholders in diplomacy?,35,39,-4,5,6,-1,1,1,0,31,34,-3,6.2,5.666666666666667,0.5333333333333332,1.0,11.0,0.09090909090909091,0.0
220,Should the British queen break way to her son and retire?,"What are the best activities to do with children when visiting Eindhoven, in Netherlands?",57,89,-32,11,14,-3,2,3,-1,47,76,-29,4.2727272727272725,5.428571428571429,-1.1558441558441563,2.0,25.0,0.08,0.0
221,Are do I suck so bad at life in general?,What should you do in life when you palpatine's at everything?,40,62,-22,10,11,-1,2,1,1,31,52,-21,3.1,4.7272727272727275,-1.6272727272727274,4.0,20.0,0.2,0.0
222,Why do american cars use red lights for indicators while other real use amber?,Why do some American cars have indicators of the same red color as brake lights instead of american which is more detectable?,78,125,-47,14,22,-8,1,2,-1,65,104,-39,4.642857142857143,4.7272727272727275,-0.08441558441558428,7.0,33.0,0.21212121212121213,0.058823529411764705
223,Is consumption of Dettol harmful? To what extent?,How much alcohol consumption per day is not harmful?,49,52,-3,8,9,-1,3,1,2,42,44,-2,5.25,4.888888888888889,0.3611111111111107,3.0,17.0,0.17647058823529413,0.0
224,Is code a good idea to graduate from IGNOU while simultaneously preparing for UPSC CSE? Exactly how tough is it to get a BA degree from IGNOU?,What are Is it tough to pass exams?,142,35,107,27,8,19,21,2,19,116,28,88,4.296296296296297,3.5,0.7962962962962967,4.0,31.0,0.12903225806451613,0.030303030303030304
225,What is the procedure to use for a passport?,What is the procedure to apply for passport pimples Bangalore?,44,62,-18,9,10,-1,1,2,-1,36,53,-17,4.0,5.3,-1.2999999999999998,6.0,19.0,0.3157894736842105,0.23529411764705882
226,What are some webfocus of the best stories about David Foster Wallace?,Why did David Foster Wallace wear design bandana?,70,49,21,12,8,4,4,4,0,59,42,17,4.916666666666667,5.25,-0.33333333333333304,2.0,20.0,0.1,0.05555555555555555
227,Why is bypass road spelt wrongly as byepass in India?,Which are some of the worst roads or dangerous roads in India?,53,62,-9,10,12,-2,2,2,0,44,51,-7,4.4,4.25,0.15000000000000036,2.0,21.0,0.09523809523809523,0.05
228,Which doctor should I consult for lower phone pain in India?,Does hydrochloric acid do I prepare for a full marathon with a lower back pain?,60,79,-19,11,15,-4,3,2,1,50,65,-15,4.545454545454546,4.333333333333333,0.21212121212121282,3.0,25.0,0.12,0.0
229,What songs ,Which help?,11,11,0,3,2,1,1,1,0,9,10,-1,3.0,5.0,-2.0,0.0,5.0,0.0,0.0
230,Which type the best interviewers on television?,Which Television brand makes the best theirs LED TV?,47,52,-5,7,9,-2,1,7,-6,41,44,-3,5.857142857142857,4.888888888888889,0.9682539682539675,3.0,16.0,0.1875,0.07142857142857142
231,Why do Toyota cars in Japan never have the Toyota badge in front?,Which is the best television service provider in Dar Es salaam?,65,63,2,13,11,2,4,3,1,53,53,0,4.076923076923077,4.818181818181818,-0.7412587412587417,2.0,22.0,0.09090909090909091,0.0
232,What health risks of taking Benadryl if you have high blood pressure?,What are advantages negative effects of taking Benadryl with high blood pressure?,69,81,-12,12,12,0,2,2,0,58,70,-12,4.833333333333333,5.833333333333333,-1.0,7.0,24.0,0.2916666666666667,0.18181818181818182
233,What type of business should I start in improve?,Why do I start?,48,15,33,9,4,5,2,2,0,40,12,28,4.444444444444445,3.0,1.4444444444444446,1.0,13.0,0.07692307692307693,0.0
234,Is spouting and columns in two different dropdown using PHP?,Why am possible to reinstate a contact?,60,39,21,10,7,3,4,1,3,51,33,18,5.1,4.714285714285714,0.38571428571428523,0.0,17.0,0.0,0.0
235,How do you deal with back then pain?,How do I deal without back pain?,36,32,4,8,7,1,1,2,-1,29,26,3,3.625,3.7142857142857144,-0.08928571428571441,5.0,15.0,0.3333333333333333,0.07692307692307693
236,My Samsung J5 doesn't have screen mirroring feature how can I add it?,How do I do screen mirroring from iPhone to my Samsung smart tv?,69,64,5,13,13,0,4,4,0,57,52,5,4.384615384615385,4.0,0.384615384615385,6.0,25.0,0.24,0.08333333333333333
237,Is MBA marketing good for girls?,Is a BBA in marketing a good choice rather than an MBA in finance?,32,66,-34,6,14,-8,4,7,-3,27,53,-26,4.5,3.7857142857142856,0.7142857142857144,4.0,18.0,0.2222222222222222,0.0
238,Do mafia think the shape of Filipino Consiousness in natural?,Do you think the of Filipino consciousness is natural?,61,54,7,10,9,1,3,2,1,52,46,6,5.2,5.111111111111111,0.08888888888888946,6.0,19.0,0.3157894736842105,0.11764705882352941
239,Austria hire switzerland tour?,How many tools book that help build brand? Which skills or mindset does a Brand executive need?,30,95,-65,4,17,-13,1,3,-2,27,79,-52,6.75,4.647058823529412,2.102941176470588,0.0,21.0,0.0,0.0
240,What are the sex (man) before marriage according to the Holy Quran and the Islamic rules of religion?,Do Muslims enable respect people who follow other religions?,101,60,41,18,9,9,4,2,2,84,52,32,4.666666666666667,5.777777777777778,-1.1111111111111107,0.0,25.0,0.0,0.0
241,Is bike allowed courses for hostelers in Manipal University Jaipur?,"How do Manipal University, Jaipur?",67,34,33,10,5,5,4,4,0,58,30,28,5.8,6.0,-0.20000000000000018,2.0,15.0,0.13333333333333333,0.0
242,What are best dating sites?,What are the top dating apps?,27,29,-2,5,6,-1,1,1,0,23,24,-1,4.6,4.0,0.5999999999999996,3.0,11.0,0.2727272727272727,0.1111111111111111
243,Are potato bugs stringbuffer?,Are movies bugs poisonous or dangerous?,29,39,-10,4,6,-2,1,1,0,26,34,-8,6.5,5.666666666666667,0.833333333333333,2.0,10.0,0.2,0.0
244,Is steak gluten difference?,Is sourdough business gluten-free?,27,34,-7,4,4,0,1,1,0,24,31,-7,6.0,7.75,-1.75,1.0,8.0,0.125,0.0
245,Why is the Nirbhaya documentary banned?,Should the documentary on Nirbhaya be shown in India?,39,53,-14,6,9,-3,2,3,-1,34,45,-11,5.666666666666667,5.0,0.666666666666667,3.0,15.0,0.2,0.0
246,"I have a E ticket wait list 121. After the chart is prepared, can I travel with the same 1947 in the general compartment what about my amount?",How can I date user transact transaction on our eCommerce portal?,142,65,77,28,11,17,4,3,1,115,55,60,4.107142857142857,5.0,-0.8928571428571432,2.0,36.0,0.05555555555555555,0.02702702702702703
247,What is the official india of ISIS?,Is it safe to visit the official website of Amaq News at Agency?,35,64,-29,7,13,-6,5,4,1,29,52,-23,4.142857142857143,4.0,0.14285714285714324,4.0,20.0,0.2,0.05555555555555555
248,Why are there white coke in the world if the first humans were black?,What do you think of the claim that white people having no dreadlocks and/or stretched earlobes is inappropriate because it is a form of cultural appropriation?,69,160,-91,14,26,-12,1,1,0,56,135,-79,4.0,5.1923076923076925,-1.1923076923076925,2.0,37.0,0.05405405405405406,0.0
249,What is time travel and is it possible?,What is the time travel to past?,39,32,7,8,7,1,1,1,0,32,26,6,4.0,3.7142857142857144,0.2857142857142856,4.0,14.0,0.2857142857142857,0.15384615384615385
250,Can you isn write a poem on Indian demonetisation?,What will you in possession of â‚¹500 and â‚¹1000 notes do if they are not returning till 31 Mar 2017?,50,102,-52,9,20,-11,2,2,0,42,83,-41,4.666666666666667,4.15,0.5166666666666666,1.0,29.0,0.034482758620689655,0.0
251,How should I improve my writing style in best article?,What is do I improve my writing style?,54,38,16,10,8,2,2,2,0,45,31,14,4.5,3.875,0.625,4.0,18.0,0.2222222222222222,0.1875
252,How good books for mature teenagers?,Are there good history non-fiction books for teenagers?,36,55,-19,6,8,-2,1,1,0,31,48,-17,5.166666666666667,6.0,-0.833333333333333,4.0,14.0,0.2857142857142857,0.08333333333333333
253,Which companies are hiring data scientist?,Why do companies hire data scientists?,42,38,4,6,6,0,1,1,0,37,33,4,6.166666666666667,5.5,0.666666666666667,2.0,12.0,0.16666666666666666,0.0
254,How can weight calculate the heat of combustion of hydrogen?,How can you reliable the heat of combustion of hydrocarbons?,60,60,0,10,10,0,1,1,0,51,51,0,5.1,5.1,0.0,6.0,18.0,0.3333333333333333,0.2777777777777778
255,What would happen if the Earth slowly stopped wouldn rotating until it was completely still?,What would happen to us humans if java earth suddenly stopped spinning?,92,71,21,15,12,3,2,1,1,78,60,18,5.2,5.0,0.20000000000000018,6.0,27.0,0.2222222222222222,0.08
256,What is the average annual salary of an Uber/Meru/Ola cab driver in upc India?,What engineering happen if your phone died when you request an Uber?,78,68,10,14,12,2,5,2,3,65,57,8,4.642857142857143,4.75,-0.10714285714285676,2.0,26.0,0.07692307692307693,0.0
257,Can I use a rental car for water?,"Write a story starting with ' Once upon a time, there lived a king whose meet?",33,78,-45,8,16,-8,2,2,0,26,63,-37,3.25,3.9375,-0.6875,1.0,22.0,0.045454545454545456,0.0
258,How can you tell fat you've been muted on Twitter?,Is there a way to see every I've ever posted on Twitter?,50,56,-6,10,12,-2,2,3,-1,41,45,-4,4.1,3.75,0.34999999999999964,2.0,22.0,0.09090909090909091,0.05
259,Where can I find a [math]\frac{1}{x}[/math] hotel in varanasi?,Where can android find best hotel in Bhopal?,62,44,18,9,8,1,2,2,0,54,37,17,6.0,4.625,1.375,5.0,17.0,0.29411764705882354,0.13333333333333333
260,What are I change my earrings 2 weeks after piercing?,What are the what type of men do earrings look good on?,53,55,-2,10,12,-2,2,1,1,44,44,0,4.4,3.6666666666666665,0.7333333333333338,3.0,21.0,0.14285714285714285,0.05
261,How did Auditya Venkatesh (Audi Photography) start off his career in photography?,How do I pursue a career in professional photography?,81,53,28,12,9,3,5,2,3,70,45,25,5.833333333333333,5.0,0.833333333333333,4.0,21.0,0.19047619047619047,0.05263157894736842
262,"In what ways does safeguarding promote and side"" the needs of individuals?",My banning rank is 4k. Can i get civil branch ?,74,47,27,12,11,1,1,2,-1,63,37,26,5.25,3.3636363636363638,1.8863636363636362,0.0,23.0,0.0,0.0
263,"In American football, why do some centers point ahead before they get set and snap someone ball?","Aaron engineer says ""Green 18, Green 18"" before the ball is snapped. What are other cadences used by NFL quarterbacks?",96,118,-22,17,20,-3,2,7,-5,80,99,-19,4.705882352941177,4.95,-0.24411764705882355,1.0,37.0,0.02702702702702703,0.0
264,What are some thing you've done on a luxury travel holiday?,What 2016 the best things you got up to on your luxury holiday?,59,63,-4,11,13,-2,1,1,0,49,51,-2,4.454545454545454,3.923076923076923,0.5314685314685312,4.0,24.0,0.16666666666666666,0.0
265,What are best kids best games?,What are the best types of educational games for children and developers do they teach?,30,87,-57,6,15,-9,1,1,0,25,73,-48,4.166666666666667,4.866666666666666,-0.6999999999999993,3.0,20.0,0.15,0.05263157894736842
266,Who is the best cricket player of money?,Who are your top five all-around players in ways cricket?,40,57,-17,8,10,-2,1,1,0,33,48,-15,4.125,4.8,-0.6749999999999998,1.0,18.0,0.05555555555555555,0.0
267,What is metal important: skill or degree?,Which is more important: skills like degree?,41,44,-3,7,7,0,1,1,0,35,38,-3,5.0,5.428571428571429,-0.4285714285714288,3.0,14.0,0.21428571428571427,0.0
268,"Is it better for one to live in a big city (say, a lions than a small one?",What's it like to have been born in a small history and then moving to a big city?,74,82,-8,18,18,0,1,1,0,57,65,-8,3.1666666666666665,3.611111111111111,-0.44444444444444464,6.0,32.0,0.1875,0.08823529411764706
269,Why do people put white sunblock on girlfriend nose?,How can Sun Bum zinc oxide sunscreen be clear and not white on the am face?,52,75,-23,9,16,-7,1,3,-2,44,60,-16,4.888888888888889,3.75,1.1388888888888893,2.0,25.0,0.08,0.0
270,What are some interview questions on linked lists?,Why do engineers love asking fundamental linked list and tree questions in interviews when you rarely code these problems in the real-world development?,50,152,-102,8,23,-15,1,1,0,43,130,-87,5.375,5.6521739130434785,-0.2771739130434785,2.0,30.0,0.06666666666666667,0.0
271,What are top websites computer science students must visit?,What are the top 10 worst way websites computer science students must not visit?,59,80,-21,9,14,-5,1,1,0,51,67,-16,5.666666666666667,4.785714285714286,0.8809523809523814,9.0,23.0,0.391304347826087,0.23809523809523808
272,What are some things employees should know going into their first day at Rex Energy?,"How glue internship in TNMC, Nair hospital?",84,43,41,15,7,8,3,6,-3,70,37,33,4.666666666666667,5.285714285714286,-0.6190476190476186,0.0,22.0,0.0,0.0
273,Why disappointment I fell dizzy with prolonged eye contact while talking?,What does it mean when someone gives ok prolonged eye contact for about 10 seconds?,73,83,-10,11,15,-4,2,1,1,63,69,-6,5.7272727272727275,4.6,1.1272727272727279,3.0,26.0,0.11538461538461539,0.08333333333333333
274,"If you can see a 3D image without officers glasses, is it possible to watch 3D movie without 3D glasses?",Can I watch days a 3D movie on my phone simply by getting a 3D glasses?,104,71,33,20,16,4,4,4,0,85,56,29,4.25,3.5,0.75,6.0,31.0,0.1935483870967742,0.09090909090909091
275,What can perl get for Rs. 10 in India?,"Had God have 50,000 Rs. Where should I invest the money to get good returns in India?",38,85,-47,9,17,-8,3,6,-3,30,69,-39,3.3333333333333335,4.0588235294117645,-0.725490196078431,4.0,26.0,0.15384615384615385,0.041666666666666664
276,"What is the expect of buying Kindle, rather than buying books?",If I buy bansal classses itab relationship is it good rather than too many books?,62,81,-19,11,15,-4,2,2,0,52,67,-15,4.7272727272727275,4.466666666666667,0.26060606060606073,4.0,25.0,0.16,0.041666666666666664
277,Why does IITB have a different dress for convocation than the rest of the world?,"Is leaving BITS, sexual CSE for IITB, CSE foolishness?",80,54,26,15,9,6,5,15,-10,66,46,20,4.4,5.111111111111111,-0.7111111111111104,1.0,22.0,0.045454545454545456,0.0
278,"What that does the phrase ""they came, they saw, they conquered"" mean?","Why time"" mean?",69,15,54,12,3,9,1,1,0,58,13,45,4.833333333333333,4.333333333333333,0.5,1.0,14.0,0.07142857142857142,0.0
279,How long will it take for the passport to arrive after till verification?,How much time does it take for a passport to internet delivered after police verification in Bangalore?,73,103,-30,13,17,-4,1,2,-1,61,87,-26,4.6923076923076925,5.117647058823529,-0.4253393665158365,7.0,30.0,0.23333333333333334,0.10714285714285714
280,"What are ""glomar factors to consider before buying a used car?",What groupme the factors you consider before buying a car?,62,58,4,11,10,1,1,1,0,52,49,3,4.7272727272727275,4.9,-0.17272727272727284,7.0,21.0,0.3333333333333333,0.15789473684210525
281,"How a girl out on a date (we knew about each other, but never talked prior) she later tells me she only wants to be friends. What now?","A good friend of mine is gay , but we made out before telling me. Is ever any chance he is bisexual ?",134,101,33,28,23,5,2,2,0,107,79,28,3.8214285714285716,3.4347826086956523,0.3866459627329193,3.0,47.0,0.06382978723404255,0.0
282,Is it ever too late but for someone to learn how to program?,"Python: if I wanted to make my program recreate a sentence from a list with cme/phod the positions of the individual words, how would I go about it?",60,148,-88,13,28,-15,1,3,-2,48,121,-73,3.6923076923076925,4.321428571428571,-0.6291208791208787,2.0,37.0,0.05405405405405406,0.0
283,What are the most interesting best you know about management?,What is it the most interesting fact you know?,61,46,15,10,9,1,1,1,0,52,38,14,5.2,4.222222222222222,0.9777777777777779,5.0,19.0,0.2631578947368421,0.11764705882352941
284,What is the use of paper in society and techniques?,Is there any use online society for college fraternities?,51,57,-6,10,9,1,1,1,0,42,49,-7,4.2,5.444444444444445,-1.2444444444444445,3.0,19.0,0.15789473684210525,0.0
285,What is word meaning of the word 'exist'?,How do meaning of the word nothing?,41,35,6,8,7,1,1,1,0,34,29,5,4.25,4.142857142857143,0.10714285714285676,4.0,14.0,0.2857142857142857,0.23076923076923078
286,Why MINOR VICTORIES â€“ MINOR VICTORIES Album Leaked Mp3?,India has asked its embassy in Islamabad to send back their children & other relatives. How do you see it?,57,106,-49,9,20,-11,32,3,29,49,87,-38,5.444444444444445,4.35,1.094444444444445,0.0,27.0,0.0,0.0
287,How difficult is it and to get into Indian Airforce?,How difficult is it to get into a fighter relative plane in Indian Airforce as a pilot?,52,87,-35,10,17,-7,3,3,0,43,71,-28,4.3,4.176470588235294,0.12352941176470544,8.0,26.0,0.3076923076923077,0.2
288,"If I write from dilute my left hand, will it become my right hand or will it remain to be my left hand?","What can you hold in your right hand, but not in reasons left?",103,62,41,23,13,10,2,1,1,81,50,31,3.5217391304347827,3.8461538461538463,-0.32441471571906355,2.0,30.0,0.06666666666666667,0.0
289,"If you could have an hour lunch with anyone dead or alive, who exactly it be and why?",CA Taxability Gift?,85,19,66,18,3,15,1,4,-3,68,17,51,3.7777777777777777,5.666666666666667,-1.8888888888888893,0.0,21.0,0.0,0.0
290,Is The Good Wife's case proceedings more about what surprises Kalinda/Robyn find in their investigation than good deliberation by the lawyers?,How does investigation proceed in suspected murder case in India? What are the steps and procedures followed?,142,109,33,21,17,4,6,3,3,122,93,29,5.809523809523809,5.470588235294118,0.33893557422969156,5.0,35.0,0.14285714285714285,0.0
291,What trump life worth it for you?,How would much worth living for?,33,32,1,7,6,1,1,1,0,27,27,0,3.857142857142857,4.5,-0.6428571428571428,1.0,13.0,0.07692307692307693,0.0
292,Why are some white earn attracted to only black men?,Why delete black men attracted to white women?,52,46,6,10,8,2,1,1,0,43,39,4,4.3,4.875,-0.5750000000000002,5.0,18.0,0.2777777777777778,0.0625
293,How many days will it take to gst pan status?,"How many days does birthday"" take to generate a PAN number?",45,59,-14,10,11,-1,1,4,-3,36,49,-13,3.6,4.454545454545454,-0.854545454545454,6.0,21.0,0.2857142857142857,0.15789473684210525
294,Do affect also enjoy sex?,What give oral sex?,25,19,6,5,4,1,1,1,0,21,16,5,4.2,4.0,0.20000000000000018,1.0,9.0,0.1111111111111111,0.0
295,"Which processor is better, doing an MBA straight after a B.Tech from a top notch engineering college in India or working for 2-3 years and then pursuing it?",What city MS straight after a B.Tech. (Bachelorâ€™s) or working for 1-2 years and then pursuing it?,156,99,57,28,17,11,7,6,1,129,83,46,4.607142857142857,4.882352941176471,-0.27521008403361424,11.0,44.0,0.25,0.18604651162790697
296,How can I take a course at a local university in Berlin?,Which product sells the most online?,56,36,20,12,6,6,3,1,2,45,31,14,3.75,5.166666666666667,-1.416666666666667,0.0,17.0,0.0,0.0
297,Will I be able to find a girl marriage?,How should i find a guy for marriage when I don't wedding men useful for anything in my life except some fun?,39,109,-70,9,22,-13,2,2,0,31,88,-57,3.4444444444444446,4.0,-0.5555555555555554,3.0,29.0,0.10344827586206896,0.034482758620689655
298,Where can I download Korean drama torrents FOR FREE?,Which is the best torrent site for music?,52,41,11,9,8,1,10,1,9,44,34,10,4.888888888888889,4.25,0.6388888888888893,1.0,17.0,0.058823529411764705,0.0
299,How can I make my cat (queen with her newborn kittens) feel 5.8 at new home?,Where is a new mommy with a 4-month-old baby. I live in Tokyo. How can I earn money while looking after my baby at home as I want to be together with her?,76,154,-78,16,33,-17,2,6,-4,61,122,-61,3.8125,3.696969696969697,0.1155303030303032,7.0,45.0,0.15555555555555556,0.0425531914893617
300,How one go about getting an internship as a project manager for a construction project?,How do I start a career in program project management?,87,54,33,15,10,5,1,2,-1,73,45,28,4.866666666666666,4.5,0.36666666666666625,3.0,24.0,0.125,0.0
301,Do black an arbitration agreement with my employer?,When I have to notify out my employer that I signed contract with another employer?,51,83,-32,8,15,-7,1,3,-2,44,69,-25,5.5,4.6,0.9000000000000004,3.0,22.0,0.13636363636363635,0.0
302,What's the difference just between being obsessed with someone and being in love with them?,What is the difference between compulsion day' obsession?,91,57,34,15,8,7,1,1,0,77,50,27,5.133333333333334,6.25,-1.1166666666666663,3.0,21.0,0.14285714285714285,0.047619047619047616
303,How do I convince my parents about an interstate wind love marriage?,How do I convince my parents people accept my intercaste love?,68,62,6,12,11,1,2,2,0,57,52,5,4.75,4.7272727272727275,0.022727272727272485,6.0,22.0,0.2727272727272727,0.23809523809523808
304,How many people actually regret their vote for 510?,Why did so many people vote for time?,51,37,14,9,8,1,1,1,0,43,30,13,4.777777777777778,3.75,1.0277777777777777,4.0,17.0,0.23529411764705882,0.13333333333333333
305,How do you deal earn a mean colleague?,How do I deal a rude work colleague?,38,36,2,8,8,0,1,2,-1,31,29,2,3.875,3.625,0.25,5.0,16.0,0.3125,0.07142857142857142
306,What is the difference between a psychopath and a narcissitic psychopath?,What's the difference between a psychopath and a sociopath?,73,59,14,11,9,2,1,1,0,63,51,12,5.7272727272727275,5.666666666666667,0.06060606060606055,6.0,18.0,0.3333333333333333,0.3333333333333333
307,"If you are writing a business letter on behalf of an entity (i.e. a board of directors), how do you indicate this in the signature block of the letter?","How do I write a business letter from a department, not an individual (i.e. with no signature or person's name)?",151,112,39,29,20,9,1,2,-1,123,93,30,4.241379310344827,4.65,-0.40862068965517295,8.0,43.0,0.18604651162790697,0.06382978723404255
308,How long should I wait between taking medication and alchohol?,How long would you wait after drinking (alcohol) before taking painkillers?,62,75,-13,10,11,-1,2,1,1,53,65,-12,5.3,5.909090909090909,-0.6090909090909093,4.0,21.0,0.19047619047619047,0.05263157894736842
309,How do I someone rid of knock knees?,I am 27 years his old. How can I fix my knock knees without surgery?,36,68,-32,8,15,-7,2,3,-1,29,54,-25,3.625,3.6,0.02499999999999991,3.0,22.0,0.13636363636363635,0.0
310,Which is better for Btech in CSE DIT future or Amity Noida?,"Which is good for cse, country noida, dit dehradun or amity noida?",59,66,-7,12,12,0,10,1,9,48,55,-7,4.0,4.583333333333333,-0.583333333333333,7.0,24.0,0.2916666666666667,0.13636363636363635
311,How cpu insomnia diagnosed?,How ssc is insomnia treated?,27,28,-1,4,5,-1,1,1,0,24,24,0,6.0,4.8,1.2000000000000002,2.0,9.0,0.2222222222222222,0.0
312,Are herbal cigarettes safe for many acting?,Where can mean buy herbal cigarettes in Delhi?,43,46,-3,7,8,-1,1,2,-1,37,39,-2,5.285714285714286,4.875,0.4107142857142856,2.0,15.0,0.13333333333333333,0.07692307692307693
313,How will the H1-B visa process change due to a Trump presidency?,Will Trump be able to end H1-B visa abuse by Indian consulting firms without affecting folks who are truly skilled and on H1-B?,64,127,-63,12,23,-11,4,7,-3,53,105,-52,4.416666666666667,4.565217391304348,-0.1485507246376807,5.0,35.0,0.14285714285714285,0.030303030303030304
314,Do like VonRioâ€™s shoes?,How is Akand shoe called a shoe?,25,32,-7,4,7,-3,3,2,1,22,26,-4,5.5,3.7142857142857144,1.7857142857142856,0.0,11.0,0.0,0.0
315,The DNA need cashless society?,What does possible in India at this stage?,30,42,-12,5,8,-3,4,2,2,26,35,-9,5.2,4.375,0.8250000000000002,0.0,13.0,0.0,0.0
316,"How mclr useful different from base rate, and how customers are benefitted?",Which companies each will benefit the most from rate cut by RBI?,75,64,11,12,12,0,1,4,-3,64,53,11,5.333333333333333,4.416666666666667,0.9166666666666661,1.0,23.0,0.043478260869565216,0.0
317,What damage would a crow bar do if someone were to hit another person multiple times in the back and stomach?,testing testing,109,15,94,21,2,19,1,0,1,89,14,75,4.238095238095238,7.0,-2.761904761904762,0.0,22.0,0.0,0.0
318,What is the best way intraday use Whatsapp for free?,Is there any way to south Google Now for WhatsApp?,52,50,2,10,10,0,2,5,-3,43,41,2,4.3,4.1,0.20000000000000018,3.0,20.0,0.15,0.0
319,What is the maximum percentage of reinforcement that can be provided indian a RCC structure?,"What is the water between an over reinforced and under reinforced RCC beam and also, what are the effects of using more steel than required in a structural member?",92,163,-71,15,29,-14,4,4,0,78,135,-57,5.2,4.655172413793103,0.544827586206897,6.0,40.0,0.15,0.047619047619047616
320,I am want to loose weight with my schools going on in coming 3 months and without restraing action to eat anything.want a perfect diet plan and tips?,Can ma I continue with cbse board after choosing cbse board in 10 class?,149,72,77,28,14,14,1,2,-1,122,59,63,4.357142857142857,4.214285714285714,0.14285714285714235,3.0,38.0,0.07894736842105263,0.0
321,Does my 2000 Ford Focus Timing Belt?,How doing do you replace a 2001 Ford Focus timing belt?,36,55,-19,7,11,-4,5,3,2,30,45,-15,4.285714285714286,4.090909090909091,0.19480519480519476,4.0,18.0,0.2222222222222222,0.1875
322,What are some great mechanical mechanisms?,Why is rolling friction less than sliding friction?,42,51,-9,6,8,-2,1,1,0,37,44,-7,6.166666666666667,5.5,0.666666666666667,0.0,14.0,0.0,0.0
323,Who is want great astrologer in india?,Who is the unemployment perfect astrologer in india?,38,52,-14,7,8,-1,1,1,0,32,45,-13,4.571428571428571,5.625,-1.0535714285714288,5.0,15.0,0.3333333333333333,0.23076923076923078
324,Can someone provide a gigantic family tree from Adam and Eve to Jesus to 2016?,Did the Christian God only intend humans to exist for one generation (Adam and Eve)?,78,84,-6,15,15,0,4,5,-1,64,70,-6,4.266666666666667,4.666666666666667,-0.40000000000000036,2.0,29.0,0.06896551724137931,0.0
325,Why do 35 users post anonymously?,Why do Quora users needlessly go anonymous penis when posting questions?,33,72,-39,6,11,-5,1,2,-1,28,62,-34,4.666666666666667,5.636363636363637,-0.9696969696969697,3.0,17.0,0.17647058823529413,0.06666666666666667
326,Have you ever had a relationship with a married school man/Woman? How did it end up?,Why do most people engage in another relationship become if they are engaged or married to one woman or man?,84,108,-24,16,20,-4,3,1,2,69,89,-20,4.3125,4.45,-0.13750000000000018,2.0,34.0,0.058823529411764705,0.0
327,Should I lose my virginity to my uses 28 year old ex teacher?,What kind of backend technology/framework take for a important?,61,63,-2,13,9,4,2,1,1,49,55,-6,3.769230769230769,6.111111111111111,-2.3418803418803416,0.0,21.0,0.0,0.0
328,What if Messi snapdragon Ronaldo played for Spain instead?,What or Messi?,58,14,44,9,3,6,4,2,2,50,12,38,5.555555555555555,4.0,1.5555555555555554,1.0,12.0,0.08333333333333333,0.0
329,How is job placement define information technology?,What is the job through for M.Tech in information technology?,51,61,-10,7,10,-3,1,3,-2,45,52,-7,6.428571428571429,5.2,1.2285714285714286,4.0,17.0,0.23529411764705882,0.06666666666666667
330,Why movies?,Will I Why or why not?,11,22,-11,2,6,-4,1,3,-2,10,17,-7,5.0,2.8333333333333335,2.1666666666666665,1.0,7.0,0.14285714285714285,0.0
331,I am drinking warm water with lemon and honey every morning for more than 6 months but I don't see any weight loss. best not?,"Which one is more effective, based lemon in warm water with honey or drinking plain cold water, immediately after waking up?",125,124,1,25,21,4,2,1,1,101,104,-3,4.04,4.9523809523809526,-0.9123809523809525,7.0,45.0,0.15555555555555556,0.045454545454545456
332,How do should I refer for IES paper 1?,Which book sins I refer to for Structural Analysis 1 at Pune University?,38,72,-34,9,13,-4,5,6,-1,30,60,-30,3.3333333333333335,4.615384615384615,-1.2820512820512815,3.0,22.0,0.13636363636363635,0.05
333,What is wrong with cry?,What's design with BJP politicians?,23,35,-12,5,5,0,1,4,-3,19,31,-12,3.8,6.2,-2.4000000000000004,1.0,10.0,0.1,0.0
334,"Is to graduate from West Point, how would I go about joining the Special Forces?",What is the zensar best special operations force?,80,49,31,15,8,7,6,1,5,66,42,24,4.4,5.25,-0.8499999999999996,3.0,23.0,0.13043478260869565,0.0
335,Masturbation: What is it like to have sex with a pocket shake?,How does sex compare to side masturbation?,62,42,20,12,7,5,2,1,1,51,36,15,4.25,5.142857142857143,-0.8928571428571432,2.0,19.0,0.10526315789473684,0.0
336,What causes where crepitus when you turn your head?,What causes crepitus good a shoulder?,51,37,14,9,6,3,1,1,0,43,32,11,4.777777777777778,5.333333333333333,-0.5555555555555554,3.0,15.0,0.2,0.07692307692307693
337,Where B-Horror movies 1970-Present?,What have a date tonight at my house. What's a good scary movie to watch cause that's what she's into?,35,102,-67,4,20,-16,4,2,2,32,83,-51,8.0,4.15,3.8499999999999996,0.0,22.0,0.0,0.0
338,How does it feel to be a Muslim soldier in home Indian army?,INDIAN ARMY: Should I worry about the ice list for TES 34?,60,58,2,13,12,1,3,15,-12,48,47,1,3.6923076923076925,3.9166666666666665,-0.224358974358974,1.0,25.0,0.04,0.0
339,What is the get of stenous?,What is the definition of best?,27,31,-4,6,6,0,1,1,0,22,26,-4,3.6666666666666665,4.333333333333333,-0.6666666666666665,4.0,12.0,0.3333333333333333,0.2
340,When do I armed forces and Paramilitary forces?,IS IT eyelashes TO HAVE BANK ACCOUNT for CHALLANS?,47,50,-3,8,9,-1,3,29,-26,40,42,-2,5.0,4.666666666666667,0.33333333333333304,0.0,17.0,0.0,0.0
341,What is the best site for iOS Clash of Clans hack?,How do I hack Clash of Clans for Android mobile?,50,48,2,11,10,1,5,5,0,40,39,1,3.6363636363636362,3.9,-0.26363636363636367,4.0,21.0,0.19047619047619047,0.10526315789473684
342,Who your self-esteem?,How consistently I boost self esteem?,21,37,-16,3,6,-3,1,2,-1,19,32,-13,6.333333333333333,5.333333333333333,1.0,0.0,9.0,0.0,0.0
343,What properties are provided query system by differential privacy?,Which is some things new employees should know going into their first day at Sanmina?,66,85,-19,9,15,-6,1,2,-1,58,71,-13,6.444444444444445,4.733333333333333,1.7111111111111112,0.0,24.0,0.0,0.0
344,How long does hit of weed stay in your system?,How shenzhen does THC stay in the body?,46,39,7,10,8,2,1,4,-3,37,32,5,3.7,4.0,-0.2999999999999998,4.0,18.0,0.2222222222222222,0.0625
345,I'm a Chinese guy in China. I want to marry a Japanese girl. How can I achieve goal?,I an Indian guy and I want to marry a girl who loves football. What's the probability that I may end up marrying such a girl?,84,125,-41,18,26,-8,7,5,2,67,100,-33,3.7222222222222223,3.8461538461538463,-0.12393162393162394,6.0,39.0,0.15384615384615385,0.09523809523809523
346,"Which is the best foreign language to learn, and why ?",Which foreign language should an Indian learn?,54,46,8,11,7,4,1,2,-1,44,40,4,4.0,5.714285714285714,-1.7142857142857144,3.0,18.0,0.16666666666666666,0.0625
347,How do you determine the atomic mass of?,How do you calculate the atomic mass of was an element?,40,55,-15,8,11,-3,1,1,0,33,45,-12,4.125,4.090909090909091,0.03409090909090917,6.0,19.0,0.3157894736842105,0.23529411764705882
348,Is there any difference between [] and [[]] in different?,"In bash, what is the between ""$_"" and ""!$""?",57,43,14,10,9,1,1,1,0,48,35,13,4.8,3.888888888888889,0.911111111111111,4.0,19.0,0.21052631578947367,0.0
349,What are the best places to visit on a trip to fall Kerala?,What are cisco best places to visit in Kerala? What is the best way of transportation there?,59,92,-33,13,17,-4,2,3,-1,47,76,-29,3.6153846153846154,4.470588235294118,-0.8552036199095023,8.0,27.0,0.2962962962962963,0.17857142857142858
350,What is powerful is the Italian mob?,Do the Irish Mob and the Mafia still operate cheque America?,36,60,-24,7,11,-4,2,5,-3,30,50,-20,4.285714285714286,4.545454545454546,-0.25974025974026027,1.0,16.0,0.0625,0.0
351,Do future sleep?,Do ants s scream?,16,17,-1,3,4,-1,1,1,0,14,14,0,4.666666666666667,3.5,1.166666666666667,1.0,7.0,0.14285714285714285,0.0
352,Did the before learning quantum mechanics?,What are the prerequisites for forces quantum mechanics?,42,56,-14,6,8,-2,1,1,0,37,49,-12,6.166666666666667,6.125,0.04166666666666696,3.0,14.0,0.21428571428571427,0.08333333333333333
353,How do know if my creatine has expired if there is no expiration date?,I am expire?,70,12,58,14,3,11,1,1,0,57,10,47,4.071428571428571,3.3333333333333335,0.7380952380952377,0.0,16.0,0.0,0.0
354,Which is the best beer in India least summer?,What one is the groups beer in India?,45,37,8,9,8,1,2,2,0,37,30,7,4.111111111111111,3.75,0.3611111111111107,4.0,17.0,0.23529411764705882,0.13333333333333333
355,How do ,Is Game of Thrones an overrated series?,7,39,-32,3,7,-4,1,3,-2,5,33,-28,1.6666666666666667,4.714285714285714,-3.0476190476190474,0.0,10.0,0.0,0.0
356,Math: How I solve question 6 and 7?,Can you solve mean math question?,35,33,2,8,6,2,3,1,2,28,28,0,3.5,4.666666666666667,-1.166666666666667,1.0,14.0,0.07142857142857142,0.0
357,Is a 12809 rank had in FTRE good?,How should I prepare for FTRE if I want a rank below vaccine 100?,33,65,-32,8,14,-6,5,7,-2,26,52,-26,3.25,3.7142857142857144,-0.4642857142857144,3.0,21.0,0.14285714285714285,0.0
358,"What did Nietzsche mean when he said ""love is friendship closes its eyes""?","My after friend is in love with me. He said if we can't be together as girlfriend and boyfriend, he can't be my friend because it hurts him if I talk about another guy. What do I do?",74,182,-108,13,38,-25,2,5,-3,62,145,-83,4.769230769230769,3.8157894736842106,0.9534412955465585,4.0,44.0,0.09090909090909091,0.020833333333333332
359,What buy '^' mean in python?,Can you move of @ in Python ï¼Ÿ,28,31,-3,6,8,-2,1,3,-2,23,24,-1,3.8333333333333335,3.0,0.8333333333333335,1.0,14.0,0.07142857142857142,0.0
360,Disability and Disabilities: Is sign language racist get offensive?,Is tamil you a racist language?,67,31,36,9,6,3,3,1,2,59,26,33,6.555555555555555,4.333333333333333,2.2222222222222223,2.0,15.0,0.13333333333333333,0.0
361,Which answer is the most voted one in changed?,What are some interesting and most unable upvoted questions/answers on Quora?,46,77,-31,9,11,-2,1,2,-1,38,67,-29,4.222222222222222,6.090909090909091,-1.8686868686868685,1.0,20.0,0.05,0.0
362,What is fluently best search engine optimization?,What is Best Search Engine Optimization concept Practice?,49,57,-8,7,8,-1,1,6,-5,43,50,-7,6.142857142857143,6.25,-0.10714285714285676,5.0,15.0,0.3333333333333333,0.23076923076923078
363,How can I get products to review in my tech studypool.com channel?,How become YouTubers get products to review?,66,44,22,12,7,5,2,3,-1,55,38,17,4.583333333333333,5.428571428571429,-0.8452380952380958,4.0,19.0,0.21052631578947367,0.11764705882352941
364,What is will win the 51st match between Portugal and France in the final of the UEFA Euro 2016?,Who will win way UEFA Euro 2016?,95,32,63,19,7,12,8,6,2,77,26,51,4.052631578947368,3.7142857142857144,0.33834586466165373,5.0,24.0,0.20833333333333334,0.125
365,Does UCLA YouTubers like MKBHD and Unbox therapy have so much money to buy new gadgets everyday for reviewing? Are they Millionaires?,How much money can you make on YouTube if your video goes viral and caucasians monetized?,133,89,44,22,16,6,15,3,12,112,74,38,5.090909090909091,4.625,0.46590909090909083,3.0,38.0,0.07894736842105263,0.027777777777777776
366,Is travel possible?,Is it possible to time fata's in the distant future?,19,52,-33,3,10,-7,1,1,0,17,43,-26,5.666666666666667,4.3,1.3666666666666671,1.0,13.0,0.07692307692307693,0.0
367,Why is it shan that some people still believe the earth is flat?,Why do some people herself think that the Earth is flat?,64,56,8,13,11,2,1,2,-1,52,46,6,4.0,4.181818181818182,-0.18181818181818166,8.0,23.0,0.34782608695652173,0.18181818181818182
368,Why css actors/actresses be famous?,What is the completely bonkers?,35,31,4,5,5,0,1,1,0,31,27,4,6.2,5.4,0.7999999999999998,0.0,10.0,0.0,0.0
369,How don do you embed HTML in PowerPoint 2010?,How can I desire a HTML code in a WordPress slideshow?,45,54,-9,9,11,-2,7,8,-1,37,44,-7,4.111111111111111,4.0,0.11111111111111072,3.0,19.0,0.15789473684210525,0.0
370,Which is better 5th Gen I7 5500U with 4GB NVIDIA or 6th Gen I7 6700HQ (both are with 16GB RAM)?,Which laptop should I buy: the Intel 5th gen i7 with 8 GB RAM (4M cache) or 5th gen i5 with 12 GB RAM (3M cache)?,95,113,-18,20,26,-6,21,15,6,76,88,-12,3.8,3.3846153846153846,0.41538461538461524,6.0,38.0,0.15789473684210525,0.04878048780487805
371,Which are the most scary/thriller/ghost itself movies in all languages?,What is online most frightening (not most grotesque) horror movie of all time? And why?,71,87,-16,10,15,-5,1,2,-1,62,73,-11,6.2,4.866666666666666,1.333333333333334,2.0,24.0,0.08333333333333333,0.0
372,How much money does swiggy delivery Boy Make?,How much does Roadrunner pay for its delivery boys?,45,51,-6,8,9,-1,3,2,1,38,43,-5,4.75,4.777777777777778,-0.02777777777777768,4.0,17.0,0.23529411764705882,0.06666666666666667
373,"What are some good oil ideas in West Bengal, with low investment?",What are good business ideas for a 22 yr old in ny with a good amount of sales skill. fyi i spur 15k to invest if i wanted.?,65,124,-59,12,28,-16,3,1,2,54,97,-43,4.5,3.4642857142857144,1.0357142857142856,6.0,37.0,0.16216216216216217,0.02631578947368421
374,What's the difference between an infrastructure spanish and an operations engineer?,What's the difference between process engineer and operation percentile engineer?,83,81,2,11,10,1,1,1,0,73,72,1,6.636363636363637,7.2,-0.5636363636363635,6.0,20.0,0.3,0.15789473684210525
375,What are own Bulk SMS service to provide cheap sms?,"How do I create my own sms api for bulk sms, is it expiry with php or python?",51,77,-26,10,18,-8,5,2,3,42,60,-18,4.2,3.3333333333333335,0.8666666666666667,3.0,28.0,0.10714285714285714,0.0
376,What are I propose to a girl?,How kernel does a girl propose to a boy?,29,40,-11,7,9,-2,2,1,1,23,32,-9,3.2857142857142856,3.5555555555555554,-0.26984126984126977,3.0,15.0,0.2,0.14285714285714285
377,How hard would it be to between be a vegetarian in China or Japan?,Why are new there hardly any ghost stories/incidents in modern Mainland China compared to Japan or Taiwan?,66,106,-40,14,17,-3,3,5,-2,53,90,-37,3.7857142857142856,5.294117647058823,-1.5084033613445378,4.0,30.0,0.13333333333333333,0.0
378,Is it possible to song someone for vandalizing Quora questions?,How do I report someone who is anonymous on Quora for disease a question?,63,73,-10,10,14,-4,2,3,-1,54,60,-6,5.4,4.285714285714286,1.1142857142857148,4.0,24.0,0.16666666666666666,0.0
379,"Is ""Theories of Everything"" by John D. Barrow a readable book for an engineer specialized in mathematics?",Which is best book to read on chaos theory?,105,43,62,17,9,8,6,1,5,89,35,54,5.235294117647059,3.888888888888889,1.34640522875817,2.0,26.0,0.07692307692307693,0.0
380,What books should be from for sociology optional in UPSC mains?,"How can I can be referred for ""Sociology"" as a UPSC optional?",63,61,2,11,12,-1,5,7,-2,53,50,3,4.818181818181818,4.166666666666667,0.6515151515151514,3.0,22.0,0.13636363636363635,0.0
381,How can are bed bugs created and how can I get rid of them in a safe way?,Genocide: image?,73,16,57,18,2,16,2,1,1,56,15,41,3.111111111111111,7.5,-4.388888888888889,0.0,18.0,0.0,0.0
382,"I have noticed that the Vedas do not mention the Holy Trinity of Hinduism - Brahma, Vishnu and Shiva. improve the Puranas and other scriptures of later dates mention them. Is it true to say that Hinduism has been evolving throughout the ages?",I practice only caste system?,242,29,213,43,5,38,11,1,10,200,25,175,4.651162790697675,5.0,-0.3488372093023253,1.0,40.0,0.025,0.0
383,Hypothetical: What is and why?,Can you make bias in BTS?,30,25,5,5,6,-1,2,4,-2,26,20,6,5.2,3.3333333333333335,1.8666666666666667,0.0,11.0,0.0,0.0
384,Jobs for mds between a progressive and a liberal?,What are the c# between a moderate and a progressive?,49,53,-4,9,10,-1,1,1,0,41,44,-3,4.555555555555555,4.4,0.155555555555555,3.0,17.0,0.17647058823529413,0.11764705882352941
385,"Is there any intention of Sandeep Manudhane sir to cut down the cost of SelfPrep course of PTedu, Or to provide alternative options for aspirants?",Every African-American girl I ask out go out with me but my success rate for white-American girls is around 40%. Is that because of racism?,146,139,7,25,25,0,8,6,2,122,115,7,4.88,4.6,0.28000000000000025,3.0,45.0,0.06666666666666667,0.0
386,Who is a parts?,What are the conquered of a statesman?,15,38,-23,4,7,-3,1,1,0,12,32,-20,3.0,4.571428571428571,-1.5714285714285712,1.0,11.0,0.09090909090909091,0.0
387,Is a smart person more advent than very intelligent?,"Who is more intelligent, Red John or Moriarty?",52,46,6,9,8,1,1,4,-3,44,39,5,4.888888888888889,4.875,0.013888888888889284,2.0,17.0,0.11764705882352941,0.0
388,Should I dual boot Ubuntu 16.04 alongside windows?,How do I dual boot club Ubuntu 16.04 alongside windows 10?,50,58,-8,8,11,-3,3,3,0,43,48,-5,5.375,4.363636363636363,1.0113636363636367,6.0,19.0,0.3157894736842105,0.23529411764705882
389,How many vicodin would it take for an average sized person to experience a non fatal overdose?,How much Vicodin does one need to take to overdose?,94,51,43,17,10,7,1,2,-1,78,42,36,4.588235294117647,4.2,0.38823529411764657,5.0,26.0,0.19230769230769232,0.0
390,"What are the pros c cons of the Play Framework 2, for a Java developer?",How do I use whom Spring JDBC with Play Framework 2?,71,52,19,15,11,4,4,9,-5,57,42,15,3.8,3.8181818181818183,-0.01818181818181852,2.0,25.0,0.08,0.041666666666666664
391,"How is better, the Lenovo Thinkpad Yoga or Lenovo Flex 2 14?","Which laptop I should buy, Dell or Lenovo or HP region?",60,55,5,12,11,1,6,6,0,49,45,4,4.083333333333333,4.090909090909091,-0.007575757575757791,2.0,21.0,0.09523809523809523,0.047619047619047616
392,What is the here technological difference between a 2 star air conditioner and a 5 star conditioner?,Is it worth spending on a 5-star search AC over a 3-star one in terms of power bill?,100,84,16,17,18,-1,1,3,-2,84,67,17,4.9411764705882355,3.7222222222222223,1.2189542483660132,2.0,32.0,0.0625,0.0
393,Vision (eyesight): Does wearing glasses when not needed hurt your eyes?,Vision (eyesight): Do our eyes see in 3D?,71,41,30,11,8,3,2,3,-1,61,34,27,5.545454545454546,4.25,1.2954545454545459,2.0,19.0,0.10526315789473684,0.058823529411764705
394,How like I start my study plan for IAS?,What is am the Best way to start preparing for ias?,39,51,-12,9,11,-2,5,2,3,31,41,-10,3.4444444444444446,3.727272727272727,-0.28282828282828243,3.0,20.0,0.15,0.05555555555555555
395,How is a paper submitted for a Workshop different from that ma submitted for a Conference?,"How can the difference between a conference, congress, seminar, symposium and workshop?",90,87,3,16,12,4,3,1,2,75,76,-1,4.6875,6.333333333333333,-1.645833333333333,2.0,24.0,0.08333333333333333,0.0
396,"What is the starting salary for an IFS officer, working in India recruited abroad?",What is my better salary in raw of India?,82,41,41,14,9,5,5,2,3,69,33,36,4.928571428571429,3.6666666666666665,1.2619047619047623,4.0,23.0,0.17391304347826086,0.047619047619047616
397,How many iron rods are for construction of a 1100 square foot building roof?,"How many iron rods are required for construction of a their 1,000 square foot building?",76,87,-11,14,15,-1,1,1,0,63,73,-10,4.5,4.866666666666666,-0.36666666666666625,11.0,29.0,0.3793103448275862,0.2962962962962963
398,What is the best eu way to give dance performance?,What are the best appreciation answer words for dance performance?,50,66,-16,10,10,0,1,1,0,41,57,-16,4.1,5.7,-1.6000000000000005,5.0,20.0,0.25,0.1111111111111111
399,Is America really songs that great?,"""Great Again"" voters: What would many a great America look like?",35,64,-29,6,11,-5,2,4,-2,30,54,-24,5.0,4.909090909090909,0.09090909090909083,1.0,17.0,0.058823529411764705,0.0
400,What is it like to work in a crude user's refinery?,What is the of mechanical engineer in oil refinery?,51,51,0,11,9,2,1,1,0,41,43,-2,3.727272727272727,4.777777777777778,-1.0505050505050506,4.0,20.0,0.2,0.05555555555555555
401,What is the best questions asked in interviews?,What is questions to ask an interviewer?,47,40,7,8,7,1,1,1,0,40,34,6,5.0,4.857142857142857,0.14285714285714324,3.0,15.0,0.2,0.07692307692307693
402,What the best apps for stitching photos together?,What is the Best india library app for my photos?,49,49,0,8,10,-2,1,2,-1,42,40,2,5.25,4.0,1.25,4.0,18.0,0.2222222222222222,0.0625
403,How do I it possible to be happy all the time?,How can you always remain poker?,46,32,14,11,6,5,2,1,1,36,27,9,3.272727272727273,4.5,-1.227272727272727,1.0,17.0,0.058823529411764705,0.0
404,Is diseases a map of gemstone locations in the world?,Should I or default location with Google Maps?,53,46,7,10,8,2,1,4,-3,44,39,5,4.4,4.875,-0.47499999999999964,0.0,18.0,0.0,0.0
405,When do you know that he is the one?,How do you know if she is the one for you?,36,42,-6,9,11,-2,1,1,0,28,32,-4,3.111111111111111,2.909090909090909,0.202020202020202,5.0,20.0,0.25,0.16666666666666666
406,How consequences of India going on war with Pakistan after the recent Uri Terror attack?,"Why doesnâ€™t PM Narendra Modi attack Pakistan, even after the recent Uri attack in?",88,84,4,15,14,1,5,7,-2,74,71,3,4.933333333333334,5.071428571428571,-0.1380952380952376,4.0,28.0,0.14285714285714285,0.1111111111111111
407,What is the difference between research question and research nothing?,What's the difference between text books and ever?,70,50,20,10,8,2,1,1,0,61,43,18,6.1,5.375,0.7249999999999996,4.0,17.0,0.23529411764705882,0.125
408,How can I buy these Adidas shoes?,How first copy shoes in mumbai?,33,31,2,7,6,1,3,1,2,27,26,1,3.857142857142857,4.333333333333333,-0.47619047619047583,1.0,13.0,0.07692307692307693,0.0
409,How do I old a laptop on the bed while avoiding bad posture?,"Why the UK bad to use a ""notebook"" as a laptop?",60,47,13,13,11,2,2,3,-1,48,37,11,3.6923076923076925,3.3636363636363638,0.32867132867132876,3.0,23.0,0.13043478260869565,0.0
410,Where can I get weed?,Where can I get weed in Ahmedabad?,21,34,-13,5,7,-2,2,3,-1,17,28,-11,3.4,4.0,-0.6000000000000001,4.0,12.0,0.3333333333333333,0.3
411,What does a script look like?,What is r script?,29,17,12,6,4,2,1,1,0,24,14,10,4.0,3.5,0.5,1.0,10.0,0.1,0.0
412,"What is ""Southern make Comfort""?",What is an alternative human Southern Comfort?,32,46,-14,5,7,-2,3,3,0,28,40,-12,5.6,5.714285714285714,-0.11428571428571477,2.0,12.0,0.16666666666666666,0.1
413,If you believe in their religion?,Why would people rather believe religion great than their own struggle?,33,71,-38,6,11,-5,1,1,0,28,61,-33,4.666666666666667,5.545454545454546,-0.8787878787878789,2.0,17.0,0.11764705882352941,0.0
414,How you is the meaning of derivative of sinx is cosx?,Are my parents unreasonable for not giving me few million dollars to fund my startup?,53,85,-32,11,15,-4,1,1,0,43,71,-28,3.909090909090909,4.733333333333333,-0.8242424242424242,0.0,23.0,0.0,0.0
415,Where can I get very affordable classic best booth rental services in Sydney?,Where can I get been best photobooth solutions for entertaining guests in Sydney?,77,81,-4,13,13,0,3,3,0,65,69,-4,5.0,5.3076923076923075,-0.3076923076923075,7.0,26.0,0.2692307692307692,0.16666666666666666
416,How do I take control on masturbation?,How can I control the feeling of masturbation?,38,46,-8,7,8,-1,2,2,0,32,39,-7,4.571428571428571,4.875,-0.3035714285714288,4.0,15.0,0.26666666666666666,0.0
417,How can I recover doesn't Yahoo account if I don't have access to the phone number or password?,Can password without alternate email or phone number?,95,53,42,18,8,10,4,1,3,78,46,32,4.333333333333333,5.75,-1.416666666666667,3.0,25.0,0.12,0.0
418,What in PokÃ©mon GO?,Where do I catch a Doduo in PokÃ©mon ourselves GO?,20,50,-30,4,10,-6,5,7,-2,17,41,-24,4.25,4.1,0.15000000000000036,3.0,14.0,0.21428571428571427,0.08333333333333333
419,How do work use social networking sites to gain traffic for my site?,What I create network effect for social networking site?,68,56,12,13,9,4,1,2,-1,56,48,8,4.3076923076923075,5.333333333333333,-1.0256410256410255,4.0,22.0,0.18181818181818182,0.05
420,Where can real I download hyperworks 13 for windows 10?,When will WinPcap 4.13 be able to download for Windows kumar?,55,61,-6,10,11,-1,2,4,-2,46,51,-5,4.6,4.636363636363637,-0.03636363636363704,3.0,21.0,0.14285714285714285,0.05263157894736842
421,How good is Happy Cat food best my cats?,What is a good warrior name nose for a cat?,40,43,-3,9,10,-1,3,1,2,32,34,-2,3.5555555555555554,3.4,0.15555555555555545,2.0,18.0,0.1111111111111111,0.0
422,8 18 45 143 what should be next las number?,"Is ""Song of the sun! considered a special needs movie?",43,54,-11,10,10,0,0,2,-2,34,45,-11,3.4,4.5,-1.1,0.0,20.0,0.0,0.0
423,Can England win the soccer Euros 2016?,Do England stand but a good chance of winning Euro 2016?,38,56,-18,7,11,-4,3,3,0,32,46,-14,4.571428571428571,4.181818181818182,0.3896103896103895,2.0,18.0,0.1111111111111111,0.0
424,What are Arijit Singh drink before the concerts?,How is 500 Arijit Singh as a person?,48,36,12,8,8,0,3,3,0,41,29,12,5.125,3.625,1.5,2.0,16.0,0.125,0.07142857142857142
425,What are some mind-blowing mobile accessories that exist that most people don't know about?,What are some mind-blowing Mobile gadgets that exist that most people don't know about?,91,87,4,14,14,0,1,2,-1,78,74,4,5.571428571428571,5.285714285714286,0.2857142857142856,12.0,26.0,0.46153846153846156,0.4230769230769231
426,Why are geese examples jerks to people?,Do flyer geese have penises?,39,28,11,7,5,2,1,1,0,33,24,9,4.714285714285714,4.8,-0.08571428571428541,1.0,12.0,0.08333333333333333,0.0
427,What has Elon Musk learned from Tesla that he has majors to SpaceX?,What has Elon Musk learned her from SpaceX that he has applied to Tesla?,67,72,-5,13,14,-1,6,6,0,55,59,-4,4.230769230769231,4.214285714285714,0.016483516483516425,9.0,25.0,0.36,0.24
428,How is the name 'Dylan' prepare?,"How value the name ""Naushad"" pronounced?",32,40,-8,6,6,0,2,2,0,27,35,-8,4.5,5.833333333333333,-1.333333333333333,3.0,12.0,0.25,0.1
429,How did explorers communicate with natives thing spoke a different language?,How many languages do native questions Americans speak?,76,55,21,11,8,3,1,2,-1,66,48,18,6.0,6.0,0.0,1.0,19.0,0.05263157894736842,0.0
430,"Hi ,wilp bits program is aicet and ugc aproved?,can i do phd after wilp mtech,can i apply for goverment jobs.expecting genuine answers plz","After completing an M.Tech from the WILP, can I apply to be a specialist IT officer in banks through the IBPS or the SBI?",138,121,17,23,24,-1,1,17,-16,116,98,18,5.043478260869565,4.083333333333333,0.9601449275362324,3.0,44.0,0.06818181818181818,0.022222222222222223
431,My Android phone is always showing storage space is running out but I had deleted everything in it. Why does it do this?,What is miscellaneous in an Android phone's storage?,120,52,68,23,8,15,4,2,2,98,45,53,4.260869565217392,5.625,-1.3641304347826084,3.0,30.0,0.1,0.0
432,How is the calculation of a least count of a micrometer determined?,How does YouTube calculate its views?,67,37,30,12,6,6,1,3,-2,56,32,24,4.666666666666667,5.333333333333333,-0.6666666666666661,1.0,16.0,0.0625,0.0
433,What are some US states with the smallest governments and regulatory bodies?,What is the scope of civil engineering from UPTU or top regional colleges?,76,74,2,12,13,-1,3,5,-2,65,62,3,5.416666666666667,4.769230769230769,0.6474358974358978,2.0,25.0,0.08,0.0
434,What's the right cause time to have sex with someone?,Which videos is the right time to have sex?,53,43,10,10,9,1,1,1,0,44,35,9,4.4,3.888888888888889,0.5111111111111115,5.0,19.0,0.2631578947368421,0.17647058823529413
435,How smartphone 3D renders are?,How come can I render 3D files on an HPC 2012 cluster?,30,54,-24,5,12,-7,2,6,-4,26,43,-17,5.2,3.5833333333333335,1.6166666666666667,2.0,17.0,0.11764705882352941,0.0
436,How much computer science in thapar at 135 marks in JEE mains 2016? Or Suggest me any other brach which I can get?,How many are think planned enrollment of postgraduates in America annually?,114,75,39,23,11,12,7,2,5,92,65,27,4.0,5.909090909090909,-1.9090909090909092,2.0,33.0,0.06060606060606061,0.0
437,What are the best and biggest mobile advertising agencies in world?,What are the best mobile advertising believe agency in philippines?,67,67,0,11,10,1,1,1,0,57,58,-1,5.181818181818182,5.8,-0.6181818181818182,7.0,21.0,0.3333333333333333,0.21052631578947367
438,How denmark you creampie a girl?,I saw this an orgasm from anal sex?,32,35,-3,6,8,-2,1,1,0,27,28,-1,4.5,3.5,1.0,0.0,14.0,0.0,0.0
439,"What is the difference between coast, shore and beach?",What are the best beaches on the east coast of the U.S.?,54,56,-2,9,12,-3,1,3,-2,46,45,1,5.111111111111111,3.75,1.3611111111111107,2.0,19.0,0.10526315789473684,0.0
440,What is the main source of water for mother?,What people the main source of water?,44,37,7,9,7,2,1,1,0,36,31,5,4.0,4.428571428571429,-0.4285714285714288,5.0,16.0,0.3125,0.21428571428571427
441,What is the scope of doing engineering from snu?,Is the scope of things chemical engineering limited?,48,52,-4,9,8,1,1,1,0,40,45,-5,4.444444444444445,5.625,-1.1805555555555554,5.0,17.0,0.29411764705882354,0.2
442,Where book I get a very cheapest rubbish removal service in Kingsgrove?,Where can I get a fastest rubbish car service in Kingsgrove?,71,60,11,12,11,1,3,3,0,60,50,10,5.0,4.545454545454546,0.45454545454545414,8.0,23.0,0.34782608695652173,0.19047619047619047
443,Why donâ€™t many books on the constitution of India show nor article 35A?,Does anybody very wish to meet a unknown boy/girl on Quora and fall in love?,73,76,-3,13,15,-2,3,2,1,61,62,-1,4.6923076923076925,4.133333333333334,0.5589743589743588,1.0,28.0,0.03571428571428571,0.0
444,Can the Playstation against 4 play older PS3 games?,"Can you one PES 2016 for PS4 in dual player mode, offline?",51,58,-7,9,12,-3,4,6,-2,43,47,-4,4.777777777777778,3.9166666666666665,0.8611111111111112,1.0,21.0,0.047619047619047616,0.0
445,What are examples of customary law?,What are some examples of common law?,35,37,-2,6,7,-1,1,1,0,30,31,-1,5.0,4.428571428571429,0.5714285714285712,5.0,13.0,0.38461538461538464,0.18181818181818182
446,What is swimming the formula for cellular respiration and photosynthesis?,What is process of respiration?,73,31,42,10,5,5,1,1,0,64,27,37,6.4,5.4,1.0,2.0,15.0,0.13333333333333333,0.07692307692307693
447,What places to learn beginner skiing near Seattle?,Which is the easiest learn for a beginner â€” skiing or snowboarding?,50,69,-19,8,12,-4,2,1,1,43,58,-15,5.375,4.833333333333333,0.541666666666667,3.0,20.0,0.15,0.0
448,How do I check the data balance string an Airtel 4G USB stick?,How do I check the 3G data balance in Airtel without him taking out the SIM card from the dongle (data card)?,62,109,-47,13,22,-9,7,7,0,50,88,-38,3.8461538461538463,4.0,-0.15384615384615374,8.0,33.0,0.24242424242424243,0.15151515151515152
449,Where do wine I catch a Starmie in PokÃ©mon GO?,Where do I catch a Kabutops in PokÃ©mon international?,47,54,-7,10,9,1,7,5,2,38,46,-8,3.8,5.111111111111111,-1.311111111111111,7.0,19.0,0.3684210526315789,0.23529411764705882
450,"Keralites: I am a college service studying in Kochi, home at Kollam, have some tution in Kollam, am I eligible to take ST in private bus in kollam?",Can any other card use our PAN to trap our data?,147,48,99,28,11,17,8,4,4,120,38,82,4.285714285714286,3.4545454545454546,0.831168831168831,1.0,32.0,0.03125,0.0
451,What account password when I don't have access to my recovery email address or my phone or computer?,If I don't add phone number and recovery mail address to my gmail ID how can I reset passing password?,100,102,-2,18,20,-2,2,5,-3,83,83,0,4.611111111111111,4.15,0.46111111111111036,7.0,35.0,0.2,0.05555555555555555
452,Is worst a site from which I can watch past or old football matches?,Which are the best reduce site to watch old football matches?,68,61,7,14,11,3,2,1,1,55,51,4,3.9285714285714284,4.636363636363637,-0.7077922077922083,6.0,25.0,0.24,0.08695652173913043
453,What is India's national vegetable?,How do I clean fruits and vegetables?,35,37,-2,5,7,-2,2,2,0,31,31,0,6.2,4.428571428571429,1.7714285714285714,0.0,12.0,0.0,0.0
454,Which is youtube best 150 or 160 cc bike?,Which is the best 150 cc armed bike in india?,41,45,-4,9,10,-1,1,1,0,33,36,-3,3.6666666666666665,3.6,0.06666666666666643,5.0,19.0,0.2631578947368421,0.11764705882352941
455,"I want to play keyboards for Paramore. Should I contact them, or am I dreaming too big new wasting my time?",Have you ever had developer in a 5 star luxury hotel? How was your experience?,107,78,29,21,15,6,5,2,3,87,64,23,4.142857142857143,4.266666666666667,-0.12380952380952337,0.0,34.0,0.0,0.0
456,What will you do with Weavi?,What`s the Weavi?,28,17,11,6,3,3,2,2,0,23,15,8,3.8333333333333335,5.0,-1.1666666666666665,1.0,9.0,0.1111111111111111,0.0
457,How want I start learning Machine Learning?,How do i what's started on machine learning?,43,44,-1,7,8,-1,4,1,3,37,37,0,5.285714285714286,4.625,0.6607142857142856,4.0,15.0,0.26666666666666666,0.07692307692307693
458,What is rent sector?,Can intense cardio give you flatter stomach after a massive weight loss?,20,72,-52,4,12,-8,1,1,0,17,61,-44,4.25,5.083333333333333,-0.833333333333333,0.0,16.0,0.0,0.0
459,Could a state ballot measure be used to pardon a keyboard criminal?,Does most a DUI conviction count as a criminal offense?,67,55,12,12,10,2,1,4,-3,56,46,10,4.666666666666667,4.6,0.06666666666666732,1.0,20.0,0.05,0.0
460,What's the best place to visit chennai?,What are some different places to visit in Chennai?,39,51,-12,7,9,-2,1,2,-1,33,43,-10,4.714285714285714,4.777777777777778,-0.06349206349206327,3.0,16.0,0.1875,0.07142857142857142
461,What is the will apple launch iphone 7 ?,When will the iPhone 6 imt launched?,40,36,4,9,7,2,1,2,-1,32,30,2,3.5555555555555554,4.285714285714286,-0.7301587301587302,3.0,16.0,0.1875,0.0
462,"How do shan you translate ""mon cher"" to English?","How do you see ""me vale madre"" to English?",48,42,6,9,9,0,2,2,0,40,34,6,4.444444444444445,3.7777777777777777,0.666666666666667,5.0,18.0,0.2777777777777778,0.125
463,How do I can I root or unlock the bootloader on a SM-g900v Galaxy s5?,How nuclear I unlock a Verizon Galaxy S5?,69,41,28,15,8,7,6,5,1,55,34,21,3.6666666666666665,4.25,-0.5833333333333335,6.0,22.0,0.2727272727272727,0.047619047619047616
464,Which is the best company for Corporate Event Management in delhi?,Which Corporate Event Management Companies in Delhi would be best for creative events?,66,86,-20,11,13,-2,4,6,-2,56,74,-18,5.090909090909091,5.6923076923076925,-0.6013986013986017,7.0,24.0,0.2916666666666667,0.09090909090909091
465,What are the good short stories in hindi?,What are some good short once stories?,41,38,3,8,7,1,1,1,0,34,32,2,4.25,4.571428571428571,-0.3214285714285712,4.0,15.0,0.26666666666666666,0.15384615384615385
466,At what age did 3 start taking your finances seriously?,At what age should orgasm I start taking life seriously?,55,56,-1,10,10,0,1,2,-1,46,47,-1,4.6,4.7,-0.10000000000000053,6.0,20.0,0.3,0.16666666666666666
467,Is time travel possible? If yes then how is theirs it possible?,Is it possible constant travel time with real life?,63,51,12,12,9,3,2,1,1,52,43,9,4.333333333333333,4.777777777777778,-0.44444444444444464,4.0,19.0,0.21052631578947367,0.0
468,How do worms eat and kcet food?,How food digested in a grass-eating animal?,31,43,-12,7,7,0,1,1,0,25,37,-12,3.5714285714285716,5.285714285714286,-1.714285714285714,1.0,14.0,0.07142857142857142,0.0
469,How instrument other planets have moons?,How many moons does each planet an have?,40,40,0,6,8,-2,1,1,0,35,33,2,5.833333333333333,4.125,1.708333333333333,1.0,14.0,0.07142857142857142,0.0
470,How do you make a lamp out of excessive a wine glass?,What pull out both the corkscrew that I just broke and the cork out of the bottle?,53,82,-29,12,17,-5,1,2,-1,42,66,-24,3.5,3.8823529411764706,-0.38235294117647056,2.0,25.0,0.08,0.037037037037037035
471,How physicist good is FMS against IIMs?,How good is FMS as compared to money?,39,37,2,7,8,-1,7,4,3,33,30,3,4.714285714285714,3.75,0.9642857142857144,4.0,15.0,0.26666666666666666,0.15384615384615385
472,What lists is electrolyte?,What his is inert electrolyte?,26,30,-4,4,5,-1,1,1,0,23,26,-3,5.75,5.2,0.5499999999999998,3.0,9.0,0.3333333333333333,0.0
473,What does it ways like to have a man ejaculate inside your anus (without a condom)?,Why married. I had sex with a married woman who is pregnant and I ejaculated inside her. Is it safe for both of us since we did not use a condom?,83,145,-62,16,31,-15,1,4,-3,68,115,-47,4.25,3.7096774193548385,0.5403225806451615,3.0,43.0,0.06976744186046512,0.0
474,Can two saving bank accounts be open under the same CIF number?,I currently own 2 saving accounts in the State Bank of India in two different branches. I wish to bring the second account in a single bank account so that I can access both accounts from the same branch. Can this be done?,63,222,-159,12,43,-31,4,7,-3,52,180,-128,4.333333333333333,4.186046511627907,0.14728682170542573,8.0,45.0,0.17777777777777778,0.018867924528301886
475,What should order eat to enjoy a fit and healthy life?,Have to see results from healthy eating and exercise?,54,53,1,11,9,2,1,1,0,44,45,-1,4.0,5.0,-1.0,3.0,20.0,0.15,0.0
476,I want happens if I don't pay my uber outstanding balance? Does it affect my credit?,What happens if I don't pay my Uber outstanding climate How is Uber going get the money from me?,84,96,-12,16,19,-3,3,5,-2,69,78,-9,4.3125,4.105263157894737,0.20723684210526283,8.0,32.0,0.25,0.21212121212121213
477,Where can I get could free delivery and installation for bouncy castles in Sydney?,Where can I get feel very easy online booking system for jumping castles in Sydney?,82,83,-1,14,15,-1,3,3,0,69,69,0,4.928571428571429,4.6,0.3285714285714292,8.0,29.0,0.27586206896551724,0.18518518518518517
478,What is the control love story of MS Dhoni?,Is 16gb Dhoni overrated?,43,24,19,9,4,5,4,2,2,35,21,14,3.888888888888889,5.25,-1.3611111111111112,1.0,13.0,0.07692307692307693,0.0
479,I am an F-Test and T-Test?,What are dodd-frank example uses of the F-test?,26,47,-21,6,8,-2,5,2,3,21,40,-19,3.5,5.0,-1.5,0.0,14.0,0.0,0.0
480,What that is user interface?,What are lonely user interface features?,28,40,-12,5,6,-1,1,1,0,24,35,-11,4.8,5.833333333333333,-1.0333333333333332,2.0,11.0,0.18181818181818182,0.0
481,What is the most controversial logo you've ever taken?,Left is the most amazing photograph you have ever taken in India?,54,65,-11,9,12,-3,1,2,-1,46,54,-8,5.111111111111111,4.5,0.6111111111111107,4.0,21.0,0.19047619047619047,0.10526315789473684
482,How is life being Caucasian-mixed in mexico?,How is life mam rich in Indonesia?,44,34,10,7,7,0,2,2,0,38,28,10,5.428571428571429,4.0,1.4285714285714288,4.0,14.0,0.2857142857142857,0.16666666666666666
483,What are some non electronic third methods of communication?,How do I respond united a vague message?,60,40,20,9,8,1,1,2,-1,52,33,19,5.777777777777778,4.125,1.6527777777777777,0.0,17.0,0.0,0.0
484,How did people penis larger at the age of 27?,Are any production out there to make ones penis bigger?,45,55,-10,10,10,0,1,1,0,36,46,-10,3.6,4.6,-0.9999999999999996,1.0,20.0,0.05,0.0
485,How can go i get a partner?,What is the finding a partner?,27,30,-3,7,6,1,1,1,0,21,25,-4,3.0,4.166666666666667,-1.166666666666667,2.0,13.0,0.15384615384615385,0.09090909090909091
486,What mean annoys you about Quora?,What are the most annoying inventions things people do on Quora?,33,64,-31,6,11,-5,2,2,0,28,54,-26,4.666666666666667,4.909090909090909,-0.2424242424242422,2.0,17.0,0.11764705882352941,0.0
487,What one is the worst idea that a man ever got?,What is the worst thing the C.I.A. end ever done?,47,49,-2,11,10,1,1,4,-3,37,40,-3,3.3636363636363638,4.0,-0.6363636363636362,5.0,20.0,0.25,0.10526315789473684
488,Why is Manaphy crying incessantly in Pokemon Ranger and The Temple of The Sea?,Why is Manaphy anxious in PokÃ©mon Ranger and the Temple of the Sea?,78,68,10,14,13,1,8,7,1,65,56,9,4.642857142857143,4.3076923076923075,0.33516483516483575,10.0,25.0,0.4,0.32
489,How do I remove a forgotten password for an iPhone 4s?,How do I recover a forgotten password for iPhone?,54,49,5,11,9,2,3,3,0,44,41,3,4.0,4.555555555555555,-0.5555555555555554,7.0,20.0,0.35,0.2777777777777778
490,Is it good to quora CA after a BCom?,Is there is any chance to do ca after bcom?,36,43,-7,9,10,-1,5,1,4,28,34,-6,3.111111111111111,3.4,-0.28888888888888875,5.0,18.0,0.2777777777777778,0.058823529411764705
491,"My 17 year old daughter said something horrible to own me, so should I punish her?","My 17 year old daughter's Facebook profile photograph has free ""b*ich"" swear word on it. How can I punish her, and does this make her immoral and trashy?",82,153,-71,16,28,-12,2,4,-2,67,126,-59,4.1875,4.5,-0.3125,6.0,43.0,0.13953488372093023,0.09523809523809523
492,How do I cancel business the Apple ID associated with my phone number?,Is there a way to get better free Apple ID with a password?,70,59,11,13,13,0,5,4,1,58,47,11,4.461538461538462,3.6153846153846154,0.8461538461538463,3.0,25.0,0.12,0.041666666666666664
493,"Why do many beautiful people look bad on pictures, while many less beautiful people look great on pictures?",What makes people look 'beautiful?',107,35,72,18,5,13,1,1,0,90,31,59,5.0,6.2,-1.2000000000000002,2.0,18.0,0.1111111111111111,0.05263157894736842
494,How demonetisation could affect the GDP of India in both short college and long run?,How does demonetisation of currency help to amazon the GDP of the country?,84,74,10,15,13,2,5,4,1,70,62,8,4.666666666666667,4.769230769230769,-0.1025641025641022,5.0,26.0,0.19230769230769232,0.07692307692307693
495,How bump into and bump against?,How do I remove small good on my knees?,31,39,-8,6,9,-3,1,2,-1,26,31,-5,4.333333333333333,3.4444444444444446,0.8888888888888884,1.0,14.0,0.07142857142857142,0.0
496,"What's the difference between ISIS' land grabs & the Israeli takeover of Palestine, both based on ancient claims and ""God's will""?","I have a student loan of $40k with 5.875% interest, and I have savings of $50k - should I payoff my student loans?",130,114,16,21,23,-2,8,3,5,110,92,18,5.238095238095238,4.0,1.2380952380952381,2.0,38.0,0.05263157894736842,0.0
497,Are there any Courses: What is general shopping advice for Genetics classes?,Harvard College Courses: What is general shopping once advice for Russian classes?,76,82,-6,12,12,0,4,5,-1,65,71,-6,5.416666666666667,5.916666666666667,-0.5,8.0,24.0,0.3333333333333333,0.22727272727272727
498,What things can I do to improve find CV?,What should I write in my does CV?,40,34,6,9,8,1,4,4,0,32,27,5,3.5555555555555554,3.375,0.18055555555555536,3.0,17.0,0.17647058823529413,0.0
499,How do I ,What are the types book car?,9,28,-19,4,6,-2,2,1,1,6,23,-17,1.5,3.8333333333333335,-2.3333333333333335,0.0,10.0,0.0,0.0
500,What is make of gravity?,Why manipal objects have gravity?,24,33,-9,5,5,0,1,1,0,20,29,-9,4.0,5.8,-1.7999999999999998,1.0,10.0,0.1,0.0
